工	aaaa
式	aad
匿	aadk
葚	aadn
慝	aadn
萁	aadw
苷	aaff
茝	aahh
芽	aaht
戒	aak
苣	aanf
苉	aaqb
荛	aatq
荫	abef
茸	abf
邛	abh
菡	abib
蒸	abio
荪	abiu
节	abj
茁	abmj
芤	abnb
菰	abry
萨	abut
匜	abv
茎	acaf
芭	acb
蓣	acnm
茅	acnt
苔	ackf
莽	adaj
蕻	akaw
苊	adbb
戎	ade
葫	adef
苦	adf
蓐	adff
萘	adfi
葳	adgy
葴	adgy
荐	adhb
葜	adhd
茬	adhf
藉	adij
藕	adiy
匪	ajdd
菲	ajdd
鄀	adkb
若	adkf
惹	adkn
苈	adlr
蒇	admy
项	admy
茂	adxy
藏	adny
荙	adpu
䓫	adsk
蕨	aduw
戡	adwa
期	adwe
基	adwf
斟	adwf
綦	adwi
勘	adwl
甚	adwn
惎	adwn
斯	adwr
蓁	adwt
其	adwu
欺	adww
茏	adxy
艿	aer
菔	aebc
莩	aebf
蒯	aeej
藐	aeeq
苴	aegf
菜	aesu
蕤	aetg
散	aety
藤	aeui
荽	aevf
芨	aeyu
鞯	akab
鞴	akah
鞳	akak
邯	afbh
靶	akcn
鞣	akcs
芸	afcu
芰	afcu
甘	afd
薷	akdj
鞑	akdp
靸	akey
芏	aff
鞋	akff
葑	afff
鞲	akff
靬	akfh
靰	akgq
靺	akgs
鞁	akhc
鞘	akie
蒜	afii
革	akj
靼	akjg
鞮	akjh
鞨	akjn
薹	afkf
薳	afkp
蕾	aklf
勒	aklt
鞅	akmd
萳	afmf
贰	afmi
苇	afnh
荸	afpb
鞍	akpv
芜	afqb
芫	afqb
鞠	akqo
鞔	akqq
莰	afqw
鞫	akqy
韂	akqy
靳	akrh
鞡	akru
某	afsu
著	afjf
蓍	afxj
鞒	aktj
荖	afxb
靽	akuf
鞧	akug
蔷	afuk
鞬	akvp
爇	afwo
鞭	akwq
菱	afwt
芙	afwu
靴	akwx
藿	akwo
靿	akxl
荆	agaj
匡	agd
菁	agef
莆	agey
芋	asj
廿	aghg
蔫	agho
苤	adhg
芣	adhu
荁	ffgg
蕙	agjn
𬟁	agkg
蔌	agkw
芾	agmh
莿	agmj
颟	agmm
𬜯	agmw
七	agn
巧	agnn
戈	agny
弋	agny
莱	agou
葬	agqa
薤	agqg
茉	agsu
苹	aguf
荚	agud
萋	agvv
荑	agxw
蘧	ahap
芷	ahf
苜	ahf
菽	ahic
𬞟	ahim
䓬	ahjj
苫	ahkf
颐	ahkm
赜	ahkm
熙	ahko
臣	ahnh
卧	ahnh
邪	ahtb
牙	ahte
鸦	ahtg
𬌗	ahtk
迓	ahtp
雅	ahto
茈	ahxb
茳	aiaf
蕖	aias
范	aibb
菹	aieg
薄	aigf
萍	aigf
蒲	aigy
菠	aihc
东	aii
莎	aiit
蕰	aijl
藻	aiks
荡	ainr
鸫	aiqg
蒎	aire
薸	aisi
菏	aisk
落	aitk
藩	aitl
汞	aiu
蒗	aiye
茫	aiyn
蕞	ajbc
鄚	ajdb
蓦	ajdc
墓	ajdf
幕	ajdh
暮	ajdj
募	ajdl
慕	ajdi
摹	ajdr
莫	ajdu
萌	ajef
昔	ajf
莳	ajfu
划	ajh
草	ajj
菖	ajjf
蔓	ajlc
鹊	ajqg
葛	ajqn
蓝	ajtl
茧	aju
郾	ajvb
𬸘	ajvg
葺	akbf
蕺	akby
叵	akd
鄞	akgb
或	akgd
彧	akge
堇	akgf
勤	akgl
惑	akgn
觐	akgq
蕗	altk
匮	akhm
蒉	akhm
莒	akkf
鹳	akkg
颧	akkm
萼	akkn
莴	akmw
𦭜	akwu
蒽	aldn
蔑	aldy
茵	aldu
苗	alf
薯	alfj
匣	alk
茄	alkf
茴	alkf
荔	alll
藟	alll
功	alt
葸	alnu
瞢	alph
甍	alpy
莲	alpu
薨	alpx
鹋	alqg
萝	alqu
菌	altu
匦	alvv
苏	alwu
芟	amcu
英	amdu
蓇	amef
苒	amff
茼	amgk
匝	amhk
萜	amhk
苘	amkf
苋	amqb
贡	amu
黇	amwk
黄	amwu
芮	amwu
蛩	amyj
恐	amyn
銎	amyq
芃	amyu
巩	amyy
苠	anab
艺	anb
芑	anb
䓛	anbm
巨	and
蔚	anff
葭	anhc
蔬	anhk
忒	ani
薜	ankf
勚	anml
贳	anmu
蕊	annn
苾	antr
芯	anu
荬	anud
世	anv
蓼	anwe
荩	anyu
苡	anyw
蔊	aojf
菼	aoou
蒌	aovf
薮	aovt
菪	apdf
蔻	apfc
茔	apff
蒄	apff
莞	apfq
蒙	apge
苎	apgf
萱	apgg
鹲	apgg
萣	apgh
莹	apgy
荥	apiu
萤	apju
蓂	apju
营	apkk
劳	aplr
荤	aplj
茕	apnf
菅	aphn
荧	apou
菀	apqb
蓥	apqf
莺	apqg
荦	aprh
䓨	aprm
苧	apsj
荣	apsu
芝	apu
葖	apwd
蓿	apwj
蓉	apwk
䓖	apwl
茓	apwu
萦	apxi
芪	aqab
茋	aqay
苑	aqbb
薢	aqeh
茚	aqgb
藓	apud
蓟	apjj
瓯	aqgy
葡	aqgy
区	aqi
荀	aqjf
苟	aqkf
茗	aqkf
擎	aqkr
檠	aqks
敬	aqkt
警	aqky
菟	aqky
殴	aqmc
苞	aqnb
菊	aqou
鸥	aqqg
欧	aqqw
萄	aqrm
葱	aqrn
蔸	arqq
芴	aqrr
茆	aqtb
获	aedu
莸	aedy
荻	aeou
艾	aqu
匹	aqv
萏	aqef
芡	aqwu
茑	aqyg
鸢	aqyg
芍	aqyu
葩	arcb
萚	arch
蓏	arcy
菝	ardy
蒱	argy
茱	ariu
芹	arj
匠	ark
蒐	arqc
菂	arqy
藠	arrr
萆	artf
茜	asf
蔈	asfi
苯	asgf
蘸	asgo
葙	ashf
蕈	asjj
苛	askf
菥	asrj
菘	aswc
苌	atay
医	atdi
繄	atdi
荞	atdj
翳	atdn
蓬	atdp
莠	ater
荇	atfh
芊	atfj
芼	atfn
莛	atfp
董	atgf
翘	atgn
薰	atgo
尧	atgq
蓰	athh
莉	atjj
蓖	atlx
薁	atmd
薇	atmt
蕃	atol
萩	atou
蘅	atqh
藜	atqi
莪	atry
萎	atvf
葎	atvh
蘩	atxi
莓	atxu
攻	aty
荓	auaj
蒴	aube
莘	aufj
薏	aujn
蕲	aujr
蔀	aukb
菩	aukf
𬜬	aukf
燕	akuo
蔽	aumt
蒂	auph
蒡	aupo
蒋	auqf
蒟	auqk
茭	auqu
茨	auqw
薪	ausr
蒺	autd
蒹	auvo
蔺	auwo
艽	avb
菇	avdf
薅	avdf
茛	aveu
𦰡	avfb
荨	avfu
萧	avij
菉	aviu
苕	avkf
茹	avkf
切	avt
莙	avtk
萸	aewu
芄	avyu
苍	awbb
䢼	awbh
蓊	awcn
葰	awct
茯	awdu
荟	awfc
茌	awff
蔡	awfi
苻	awfu
葵	aogd
蒨	awge
荃	awg
莶	awgi
匼	awgk
蔹	awgt
莜	awht
芥	awjj
茽	awkh
葆	awks
巷	awnb
孽	awnb
糵	awno
蘖	awns
恭	awiu
薛	awnf
荷	awsk
茶	awsu
荏	awtf
荼	awsw
共	awu
莅	awuf
蓓	awuk
芬	awvb
棻	awvs
莝	awwf
鹀	awwg
巫	awwi
觋	awwq
苁	awwu
花	awxb
苓	awyc
萑	awof
劐	awoj
芩	awyn
菍	awyn
蕉	awoo
荭	axaf
芎	axb
荮	axfu
莼	axgn
茀	axjj
蕴	axjl
蔃	axkj
药	axqy
薿	axth
芗	axtr
蒻	axuu
芘	axxb
荜	axxf
蒈	axxr
蔗	ayao
芳	aor
蓠	aybc
茺	aycq
苄	ayhu
荠	ayjj
蔼	ayjn
蓑	ayke
蘘	ayke
𫇭	ayly
蒿	aymk
藁	ayms
匾	ayna
萹	ayna
芒	aynb
藨	ayno
荒	aynk
芦	aynr
荄	aynw
葶	ayps
蘑	aysd
蘼	aysd
藦	aysr
蔟	aotd
芠	ayu
莨	ayve
蓢	ayve
萃	aywf
蓄	ayxl
蕹	ayxo
陈	baiy
子	bbbb
陬	bbcy
孖	bbg
耶	bbh
𠙶	bbk
陉	bcag
颞	bccm
聂	bccu
鄹	bctb
聚	bcti
娶	bcvf
取	bcy
隋	bdae
隳	bdai
堕	bdef
随	bdep
承	bdii
陌	bdjg
陑	bdmj
陇	bdxy
阴	beg
阻	begg
孺	bkdj
陡	bfhy
际	bfiy
阱	bfjh
陆	bfmh
阮	bfqn
陵	bfwt
卫	bgd
耳	bghg
隔	bgkh
陋	bgmn
陕	bgud
陂	bhcy
耻	bhg
蚩	bhgj
骘	bhic
陟	bhit
阽	bhkg
函	bibk
卺	bigb
丞	bigf
烝	bigo
隙	biji
逊	bipi
孙	biy
陧	bjfg
阳	bjg
隅	bjmy
隰	bjxo
亟	bkcg
聩	bkhm
𬯎	bkhm
陨	bkmy
职	bkwy
孟	blf
隈	blge
阵	blh
勐	bllt
䢺	bmbh
聃	bmfg
祟	bmfi
聘	bmgn
出	bmk
𬮿	bmnn
粜	bmou
了	bnh
孑	bnhg
也	bnhn
孔	bnn
耿	boy
院	bpfq
辽	bpk
耽	bpqn
聍	bpsh
陀	bpxn
孢	bqnn
陶	bqrm
聊	bqtb
陷	bqeg
隐	bqvn
孤	brcy
阪	brcy
隍	brgg
陎	briy
隗	brqc
陴	brtf
耵	bsh
阿	bskg
陞	btaf
降	btah
聒	btdg
阡	btfh
陲	btgf
隆	btgg
阼	bthf
隩	btmd
孜	bty
联	budy
隧	buep
障	bujh
陪	bukg
聪	bukn
隘	buwl
限	bvey
𨺙	beqn
坠	bwff
附	bwfy
险	bwgi
隃	bwgj
阶	bwjh
除	bwsw
队	bwy
聆	bwyc
乸	bxgu
陛	bxxf
孓	byi
𬯀	byjh
防	bot
孩	bynw
陔	bynw
𨚕	cabh
颈	cadm
骐	cadw
弁	caj
刭	cajh
劲	calt
迳	capd
驱	caqy
戏	cay
骁	catq
巯	cayk
骤	cbci
预	cnhm
邓	cbh
予	cnhj
驰	cbn
豫	cnhe
骛	cnhc
鹜	cnhg
鹬	cnhg
瞀	cnhh
蝥	cnhj
蟊	cnhj
矞	cnhk
矜	cnhn
遹	cnhp
鍪	cnhq
矛	cnht
柔	cnhs
婺	cnhv
又	cccc
叕	cccc
垒	cccf
骉	cccf
叠	cccg
剟	cccj
颡	cccm
桑	cccs
骖	ccde
驿	ccfh
骀	cckg
骏	ccwt
双	ccy
驭	ccy
骚	ccyj
叁	cddf
毵	cden
参	cder
𬴃	cdhd
𬴂	cjdd
畚	cdlf
𫘪	cdri
骑	cdsk
驮	cdy
驵	cegg
甬	cehj
勇	cehl
恿	cehn
通	cehp
𫘬	cexd
熊	cexo
能	cexx
圣	cff
怼	cfnu
骦	cksh
对	cfy
𬳵	cdhg
骊	cgmy
驲	cjg
𫘨	cjgh
骒	cjsy
邰	ckbh
台	ckf
驯	ckh
怠	cknu
炱	ckou
迨	ckpd
驶	ckqy
枲	cksu
骃	cldy
驷	clg
劝	clt
骡	clxi
骋	cmgn
岊	cmj
𬳶	cmkg
观	cmqn
骣	cnbb
巴	cnhn
马	cnng
𫘝	cnwy
𬴊	coqh
驼	cpxn
允	cqb
驹	cqkg
驳	cqqy
𫘦	cqrm
驺	cqvg
欢	cqwy
鸡	cqyg
骝	cqyl
牟	crhj
骠	csfi
骄	ctdj
矣	ctdu
欸	ctdw
𬳽	crqn
骆	ctkg
骢	ctln
骈	cuah
骍	cufh
骥	cuxw
艰	cvey
骕	cvij
𫘧	cviy
骎	cvpc
驸	cwfy
骙	cogd
验	cwgi
皴	cwtc
逡	cwtp
𬳿	cwsw
骅	cwxf
难	cwog
骓	cwog
驻	cygg
叉	cyi
蚤	cyju
骧	cyke
骗	cyna
骟	cynn
驴	cynt
骇	cynw
𫠊	cyny
𫘜	cyy
磡	dadl
厮	dadr
左	daf
矼	dag
砑	daht
礴	daif
厝	dajd
碏	dajg
砸	damh
碟	dans
礞	dape
奁	daqu
砹	daqy
硗	datq
砌	davt
硔	dawy
硭	dayn
顾	dbdm
耷	dbf
础	dbmh
厄	dbv
硁	dcag
磉	dccs
碜	dcde
码	dcg
翃	dcng
友	dcu
雄	dcwo
大	dddd
靥	dddd
磊	dddf
砺	dddn
飙	dddq
碱	ddgy
碶	ddhd
厦	ddht
厌	ddi
奭	ddjj
厣	ddlk
黡	ddlo
硕	ddmy
厖	ddny
励	ddnl
厉	ddnv
鿎	ddpy
䃎	ddqq
魇	ddrc
套	dku
餍	ddwe
髢	kebb
郁	debh
硼	deeg
有	def
髻	kefk
鬒	kefw
胡	deg
砠	degg
髡	kegq
髭	kehx
鬘	kejc
鬟	kele
髯	kemf
鬃	kepi
鬓	kepw
鹕	deqg
髦	ketn
鬏	keto
鬈	keub
髫	kevk
鬣	kevn
髽	kewf
髹	kews
奔	dfaj
磕	dfcl
砝	dfcy
辱	dfef
辰	dfei
蜃	dfej
唇	dfek
奎	dfff
硅	dffg
矸	dfh
奈	dfiu
礌	dklg
夸	dfnb
刳	dfnj
匏	dfnn
砖	dfny
瓠	dfny
礵	dksh
奢	dfjf
夺	dfu
砆	dfwy
压	dfyi
研	dgah
硎	dgaj
砘	dgbn
碃	dgeg
三	dggg
古	dghg
硬	dgjq
觱	dgkh
厨	dgkf
感	dgkn
咸	dgky
礓	dglg
𥕢	dgmj
碛	dgmy
戌	dgxy
厂	dgt
石	dgtg
犬	dgty
砰	dguf
硖	dgud
威	dgvy
碡	dgxu
戛	dhau
存	dhbd
破	dhcy
酆	dhdb
砉	dhdf
奡	dhdj
慧	dhdn
彗	dhdv
𬒔	dheg
在	dhfd
蹙	dhil
戚	dhiy
丰	dhk
砧	dhkg
艳	dhqc
夏	dhtu
契	dhvd
䂮	dhvd
絜	dhvi
恝	dhvn
挈	dhvr
㛃	dhvv
耤	diaj
耢	dial
磲	dias
耔	dibg
耙	dicn
耨	didf
耰	didt
硝	dieg
耘	difc
耩	diff
耕	difj
耒	dii
耥	diik
耖	diit
耦	dijy
耜	dinn
耧	diov
耗	ditn
砂	ditt
泵	diu
耪	diuo
耠	diwk
耱	diyd
厚	djbd
非	jddd
裴	jdde
韭	jddg
蜚	jddj
剕	jddj
皕	djdj
辈	jddl
悲	jddn
翡	jddn
棐	jdds
斐	jddy
百	djf
厘	djfd
碍	djsy
砷	djhh
奄	djnb
鹌	djng
碣	djqn
𬒗	djtq
右	dkf
夼	dkj
𥔲	dkkn
𥖨	dkks
夯	dlr
奋	dlf
碨	dlge
砗	dlh
厍	dlk
历	dle
碘	dmaw
碳	dmdo
碉	dmfk
硐	dmgk
布	dmhj
面	dmjd
耏	dmje
耐	dmjf
鸸	dmjg
而	dmjj
厕	dmjk
勔	dmjl
恧	dmjn
耍	dmjv
矶	dmn
硙	dmnn
砚	dmqn
砜	dmqy
页	dmu
矾	dmyy
碾	dnae
臧	dndy
尨	dney
尪	dngd
嘏	dnhc
尴	dnjl
虿	dnju
趸	dnlr
劢	dnlt
盛	dnxl
成	dnxy
迈	dnpv
尥	dnqy
砀	dnrt
万	dnv
尤	dnyi
尢	dnv
尬	dnwj
砄	dnwy
戊	dxyi
盔	dolf
磷	doqh
灰	dou
碹	dpgg
碇	dpgh
达	dpi
碗	dpqb
牵	dprh
硿	dpwa
砣	dpxn
碈	dqaj
磔	dqas
砥	dqay
克	dqb
硊	dqdb
兢	dqdq
确	dqeh
砾	dqiy
剋	dqjk
爽	dqqq
奓	dqqu
砍	dqwy
鸪	dqyg
斫	drh
原	drii
愿	drin
碑	drtf
硒	dsg
砵	dsgg
厢	dshd
碴	dsjg
磹	dsjh
厅	dsk
奇	dskf
剞	dskj
欹	dskw
邦	dtbh
帮	dtbh
硚	dtdj
焘	dtfo
寿	dtfu
砟	dthf
硌	dtkg
硇	dtlq
矻	dtnn
磻	dtol
砭	dtpy
硪	dtry
故	dty
劂	dubj
厥	dubw
磙	duce
磋	duda
砬	dug
辜	dufj
䃅	dujf
鹩	dujg
碚	dukg
碰	duog
碲	duph
磅	dupo
磏	duvw
磁	duxx
厩	dvcq
硍	dvey
肆	kvfh
碌	dviy
砼	dwag
奉	dwfh
磜	dwfi
奏	dwgd
磴	dogu
仄	dwi
泰	dwiu
春	dwjf
蠢	dwjj
秦	dwtu
舂	dwef
赝	dwwm
雁	dwwo
碓	dwog
礁	dwoo
龚	dxyw
聋	dxyb
砻	dxyd
垄	dxyf
䶮	dxyd
龙	dxyi
砒	dxxn
袭	dxye
詟	dxyy
礅	dybt
硫	dyck
砫	dygg
丈	dyi
太	dyi
碥	dyna
戍	dyxy
态	dynu
矿	dyt
碎	dywf
腻	eafm
肛	eag
胨	eaiy
膜	eajd
腊	eajg
朦	eape
郛	ebbh
服	ebcy
孕	ebf
孚	ebf
朏	ebmh
乳	ebnn
胫	ecag
胎	eckg
戤	ecla
盈	eclf
肥	ecn
肱	edcy
胈	edcy
胯	edfn
𦙶	edg
腓	ejdd
腌	edjn
腼	edmd
媭	edmv
须	edmy
腠	edwd
胧	edxy
肽	edyy
貘	eead
䝙	eeaq
脬	eebg
貊	eedj
月	eeee
豺	eeft
脟	eefy
朋	eeg
貆	eegg
豳	meei
燹	eeou
鹏	eeqg
豹	eeqy
豸	eer
邈	eerp
貌	eerq
貉	eetk
貔	eetx
貂	eevk
貅	eews
豚	eey
豮	efam
脚	efcb
肢	efcy
胠	efcy
臑	ekdj
肚	efg
肝	efh
虢	efhm
䏡	efiy
肼	efjh
臌	efkc
膨	efke
腩	efmf
肟	efnn
䏝	efny
脖	efpb
爰	eftc
肤	efwy
肘	efy
肫	egbn
悬	egcn
县	egcu
且	egd
膊	egef
腈	egeg
脯	egey
脿	egey
胚	edhg
膈	egkh
助	eglt
肺	egmh
豕	egty
雎	egwo
胰	egxw
胩	ehhy
鼐	ehnn
胪	ehnt
膛	eipf
胱	eiqn
朓	eqiy
尕	eiu
胆	ejgg
刖	ejh
胂	ejhh
腽	ejlg
腥	ejtg
肿	ekhh
腭	ekkn
臊	ekks
脶	ekmw
胭	eldy
腘	elgy
胛	elh
肋	elt
腮	elny
䐃	elty
爵	elvf
胁	elwy
腆	emaw
股	emcy
腨	emdj
胴	emgk
肌	emn
觅	emqb
肭	emwy
腒	endg
脲	eniy
肠	enrt
甩	env
膦	eoqh
𦝼	eovg
脒	eoy
受	epcu
爱	epdc
脓	epey
腙	epfi
脘	epfq
腚	epgh
逐	epi
腕	epqb
舜	epqh
膑	eprw
胺	epvg
腔	epwa
胝	eqay
脆	eqdb
豨	eqdh
朐	eqkg
胞	eqnn
胸	eqqb
脎	eqsy
肷	eqwy
胍	ercy
腯	erfh
腺	eriy
鹞	ermg
繇	ermi
遥	ermp
脾	ertf
彩	eset
膘	esfi
采	esu
腰	esvg
膝	eswi
胀	etay
胣	etbn
臜	erqm
胜	etgg
胙	ethf
腹	etjt
胳	etkg
乃	ent
用	ehk
胼	euah
腾	eudc
塍	eudf
䲢	eudp
滕	eudi
縢	eudi
螣	eudj
膳	eudk
媵	eudv
朕	eudy
胖	eufh
臆	eujn
脱	eukq
膀	eupo
胶	euqy
䏲	euxt
腿	evep
妥	evf
舀	eef
腱	evfp
腴	eewy
胗	ewet
脍	ewfc
肸	ewfh
脸	ewgi
腧	ewgj
脞	ewwf
谿	exdk
奚	exdu
脂	exjg
膙	exkj
脑	eybh
脏	eyfg
及	eyi
脐	eyjh
膻	eylg
肮	eymn
肪	eot
脉	eyni
胲	eynw
腑	eywf
腋	eywy
臃	eyxo
墈	fadl
堪	fadn
霰	kaet
霸	kake
坩	fafg
卉	faj
堰	fajv
哉	fakd
域	fakg
墐	fakg
载	falk
戴	falw
贲	famu
堞	fans
𫭼	fapl
𫭟	faqy
栽	fasi
塔	fawk
截	fawo
裁	faye
邗	fbh
地	fbn
弆	fcaj
却	fcbh
𨙸	fcbh
㙍	fccc
𫠆	fcdm
叆	fcec
埇	fceh
盍	fclf
动	fclt
劫	fclt
翅	fcnd
运	fcpi
魂	fcrc
埃	fctd
云	fcu
支	fcu
去	fcu
叇	fcvp
震	kdfe
堐	fdff
垮	fdfn
霏	kjdd
埯	fdjn
雳	kdlr
坜	fdlt
堧	fdmd
需	kdmj
颥	kdmm
顸	fdmy
城	fdny
垯	fdpy
塬	fdri
埼	fdsk
堾	fdwj
垺	febg
霾	keef
堋	feeg
埒	fefy
坥	fegg
圾	feyy
邽	ffbh
邿	ffbh
坛	ffcy
圭	fff
土	ffff
垚	ffff
堼	ffff
封	fffy
埴	ffhg
填	ffhw
卦	ffhy
款	ffiw
墘	ffjn
雩	kfnb
鄠	kfnb
圬	ffnn
恚	ffnu
堵	ffjg
寺	ffu
墙	ffuk
堎	ffwt
坉	fgbn
垤	fgcf
博	fgef
埔	fgey
圩	fsh
二	fgg
干	fggh
十	fgh
士	fghg
墕	fgho
寸	fghy
雨	kghy
坯	fdhg
坏	fdhy
垣	fgjg
埂	fgjq
塥	fgkh
垭	fgog
坪	fguf
墟	fhag
越	fhay
趣	fhbc
坡	fhcy
趄	fheg
直	fhf
矗	fhfh
赶	fhfk
址	fhg
趔	fhgj
赴	fhhi
趟	fhik
埗	fhit
亍	fhk
坫	fhkg
盐	fhlf
赳	fhnh
垆	fhnt
起	fhnv
趯	fhno
赵	fhqi
趋	fhqv
趱	fhrm
走	fhu
趑	fhuw
超	fhvk
趁	fhwe
颠	fhwm
真	fhwu
霄	kief
霪	kief
霈	kigh
未	fii
埫	fimk
垙	fiqn
釐	fitf
漦	fiti
嫠	fitv
示	fiu
垱	fivg
墚	fivs
裘	fiye
求	fiyi
逑	fiyp
救	fiyt
戟	fjay
朝	fjeg
埋	fjfg
韩	fjfh
垾	fjfh
埘	fjfy
斠	fjgf
坦	fjgg
堤	fjgh
遘	fjgp
觏	fjgq
刊	fjh
坤	fjhh
亓	fjj
井	fjk
墁	fjlc
塌	fjng
进	fjpk
堨	fjqn
埸	fjqr
乾	fjtn
斡	fjwf
翰	fjwn
颉	fkdm
袁	fkeu
吉	fkf
喆	fkfk
埕	fkgg
圳	fkh
露	kltk
酃	fkkb
劼	fklt
埚	fkmw
埙	fkmy
鼓	fkuc
彭	fkue
鼙	fkuf
瞽	fkuh
喜	fkuk
嘉	fkuk
嚭	fkuk
甏	fkuy
憙	fkun
熹	fkuo
堌	fldg
雷	klf
堽	flgh
协	flwy
塄	flot
垌	fmgk
击	fmk
坰	fmkg
垲	fmnn
垛	fmsy
献	fmud
南	fmuf
坝	fmy
坍	fmyg
霨	knff
霞	knhc
韨	fnhy
韦	fnhk
韫	fnhl
违	fnhp
韬	fnhe
韧	fnhy
墀	fnih
霹	knkf
磬	fnmd
馨	fnmj
罄	fnmm
圮	fnn
圯	fnn
声	fnr
场	fnrt
志	fnu
卖	fnud
觌	fnuq
亏	fnv
𪤗	fnwe
块	fnwy
坭	fnxn
专	fnyi
赧	fobc
郝	fobh
赭	fofj
赫	fofo
墣	fogw
赪	fohm
螫	fotj
赦	foty
赤	fou
𪣻	fovg
孛	fpbf
鹁	fpbg
勃	fpbl
垸	fpfq
彀	fpgc
縠	fpgc
觳	fpgc
壸	fpgg
懿	fpgn
壹	fpgu
过	fpi
毂	fplc
疐	fplh
壳	fpmb
悫	fpmn
壶	fpog
垞	fpta
榖	fptc
垵	fpvg
埪	fpwa
索	fpxi
坨	fpxn
坻	fqay
元	fqb
顽	fqdm
埆	fqeh
鼋	fqkn
堍	fqky
雹	kqnb
坞	fqng
远	fqpv
均	fqug
鋆	fquq
无	fqv
坎	fqwy
坂	frcy
坬	frcy
垢	frgk
圻	frh
埤	frtf
坼	fryy
堙	fsfg
圢	fsh
霜	kshf
鹴	kshg
坷	fskg
霖	kssu
㙘	fsvg
鿍	ftah
圫	ftan
孝	fbf
教	fbty
才	fte
圲	ftfh
霆	ktfp
埵	ftgf
考	fgnb
垍	fthg
鼒	fthn
埏	fthp
都	fjbh
者	fjf
翥	fjnf
煮	fjou
垎	ftkg
雾	ktlr
垧	ftmk
圪	ftnn
墦	ftol
耇	fnkf
老	fxb
耋	fxgf
耆	fxjf
耄	fxtn
霉	ktxu
垟	fudh
墡	fudk
丧	fueu
幸	fufj
垃	fug
𫮃	fujh
境	fujq
培	fukg
增	fulj
啬	fulk
墒	fumk
塝	fupo
霎	kuvf
垠	fvey
雪	kvf
垏	fvfh
埭	fviy
埽	fvph
霓	kvqb
塅	fwdc
替	fwfj
辇	fwfl
逵	fwfp
夫	fwi
鬶	fwmh
规	fwmq
堠	fwnd
埠	fwnf
坋	fwvt
赍	fwwm
𫭢	fwxn
零	kwyc
坽	fwyc
霍	kwof
堆	fwog
埝	fwyn
毐	fxdr
坳	fxlt
雱	kor
垴	fybh
墩	fybt
垿	fych
堉	fyce
霅	kyf
霁	kyjj
霭	kyjn
壤	fyke
坑	fymn
坊	fot
𡎚	fyna
垓	fynw
塆	fyox
壕	fype
圹	fyt
雯	kyu
埌	fyve
墉	fyvh
𡐓	fyvi
塘	fyvk
坟	fyy
邢	gabh
琪	gadw
形	gaet
玒	gag
𫞩	gagw
琊	gahb
武	gahd
鹉	gahg
玡	gaht
弄	gaj
型	gajf
刑	gajh
开	gak
瑾	gakg
瓘	gako
瑛	gamd
璜	gamw
璥	gaqt
珙	gawy
珥	gbg
邨	gbnb
顿	gbnm
屯	gbnv
郅	gcfb
至	gcff
到	gcfj
致	gcft
臻	gcft
玛	gcg
瑚	gdeg
珛	gdeg
玤	gdhh
天	gdi
琲	gjdd
蚕	gdju
吞	gdkf
顼	gdmy
珹	gdny
忝	gdiu
琦	gdsk
琫	gdwh
瑃	gdwj
瑧	gdwt
珑	gdxy
琈	gebg
青	gef
瑗	gefc
玥	geg
珇	gegg
𬷕	gehg
逋	gehp
敷	geht
甫	gehy
靓	gemq
瑷	gepc
靛	geph
䴖	geqg
静	geqh
瑶	germ
表	geu
琢	geyy
邘	sbh
珐	gfcy
瓀	gkdj
珪	gffg
㻬	gkfn
玕	gfh
瑱	gfhw
球	gfiy
琎	gfjp
于	sggh
盂	slf
𤩽	gfmd
玮	gfnh
迂	spk
玩	gfqn
玞	gfwy
珷	ggah
琶	ggcb
王	gggg
戋	fxyi
璱	gggt
五	gghg
环	gdhy
珸	ggkg
瑓	ggli
一	ggll
玙	ggng
瑟	ggnt
瑨	ggoj
璈	ggqt
玶	gguf
琴	ggwn
琵	ggxx
珏	ggyy
璩	ghae
琥	gham
玻	ghcy
正	ghd
鄢	ghgb
焉	ghgo
下	ghi
琡	ghic
玷	ghkg
丏	ghnn
忑	ghnu
丐	ghnv
璨	ghqo
政	ghty
玼	ghxn
甭	dheh
邳	dhgb
丕	dhgf
歪	dhgh
不	dhi
否	dhkf
琐	gimy
还	dpi
珧	gqiy
珖	giqn
孬	dhvb
珰	givg
理	gjfg
亘	gjgf
芈	gjgh
瑅	gjgh
刬	fxyj
瑁	gjhg
珅	gjhh
惠	gjhn
甦	gjqg
更	gjqi
瑆	gjtg
琨	gjxx
璟	gjyi
郚	gkbh
琄	gkeg
吾	gkf
珵	gkgg
囊	fkpe
蠹	fkpj
璐	gltk
橐	fkps
整	gkih
束	gkii
剌	gkij
赖	gkim
速	gkip
敕	gkit
卅	gkk
噩	gkkk
璪	gkks
副	gklj
逼	gklp
鹝	gkmg
鬲	gkmh
融	gkmj
翮	gkmn
鬷	gkmt
带	gkph
吏	gkqi
敔	gkty
豇	gkua
豌	gkub
豉	gkuc
豆	gkuf
剅	gkuj
逗	gkup
事	gkvh
画	glbj
盏	fxyl
柬	glii
珈	glkg
珕	glll
琏	glpy
曹	gmaj
遭	gmap
瑞	gmdj
再	gmfd
䴓	tmhg
棘	gmii
刺	gmij
枣	gmiu
僰	gmiw
𪟝	gmlt
珊	gmmg
璎	gmmv
玑	gmn
现	gmqn
责	gmu
邴	gmwb
丙	gmwi
两	gmww
璀	gmwo
郦	gmyb
鹂	gmyg
逦	gmyp
丽	gmyy
珉	gnan
琚	gndg
珝	gng
与	gngd
欤	gngw
瑕	gnhc
瑂	gnhg
玘	gnn
玚	gnrt
珌	gntt
璆	gnwe
玦	gnwy
瓦	gnny
慭	godn
严	godr
戬	goga
鄑	gogb
亚	gogd
垩	gogf
晋	gogj
恶	gogn
璞	gogw
灭	goi
来	goi
赉	gomu
琰	gooy
璘	goqh
𤫉	gyoc
琮	gpfi
瑄	gpgg
琔	gpgh
珲	gplh
琯	gphn
琬	gpqb
瑢	gpwk
琛	gpws
殣	gqag
殛	gqbg
殆	gqck
殍	gqeb
殂	gqeg
殖	gqfh
殪	gqfu
残	gqfy
歹	gqi
𬍛	gqiy
裂	gqje
珣	gqjg
䴕	gqjg
列	gqjh
虺	gqji
烈	gqjo
殒	gqkm
殁	gqmc
殃	gqmd
殡	gqpw
殉	gqqj
殊	gqri
聱	gqtb
珋	gqtb
骜	gqtc
獒	gqtd
歼	gqtf
鳌	gqtp
螯	gqtj
赘	gqtm
嶅	gqtm
熬	gqto
遨	gqtp
鏊	gqtq
殇	gqtr
敖	gqty
殚	gquf
兀	gqv
琤	gqvh
殄	gqwe
餮	gqwe
殓	gqwi
死	gqxb
玖	gqyy
玓	gqyy
碧	grdf
珀	grg
瑝	grgg
珠	griy
瑔	griy
瑰	grqc
璬	grot
玎	gsh
末	gsi
珂	gskg
琳	gssy
琇	gtet
珩	gtfh
瓒	grqm
珽	gtfp
麸	gqfw
珞	gtkg
瑀	gtky
璁	gtln
珦	gtmk
璠	gtol
麹	gtqo
麦	gtu
玫	gty
瑳	guda
璲	guep
平	gufk
璋	gujh
𤧛	guph
郏	gudb
夹	gudi
颊	gudm
珢	gvey
珒	gvfh
𬍤	gvfy
郪	gvhb
妻	gvhv
琭	gviy
玿	gvkg
珺	gvtk
瑙	gvtq
玳	gway
玱	gwbn
瑖	gwdc
珍	gwet
瑜	gwgj
璒	gogu
玠	gwjh
玢	gwvn
玲	gwyc
琟	gwog
琀	gwyk
瑑	gxey
纛	gxfi
互	gxgd
毒	gxgu
素	gxiu
夷	gxwi
玭	gxxn
璃	gybc
琉	gyck
珫	gycq
斑	gygg
玉	gyi
琼	gyiy
瓖	gyke
璮	gylg
班	gytg
璇	goth
琅	gyve
瑭	gyvk
玹	gyxy
玟	gyy
虐	haag
遽	haep
眶	hagg
甗	hagy
瞒	hagw
虞	hakd
瞄	halg
虏	hale
彪	hame
虤	hamm
虎	hamv
虑	hani
虚	haog
觑	haoq
眍	haqy
虔	hayi
颇	hcdm
皮	hci
眙	hckg
眸	hcrh
睃	hcwt
睚	hdff
䴗	hdqg
瞭	hdui
眬	hdxy
肯	hef
瞬	heph
睬	hesy
瞌	hfcl
歧	hfcy
眭	hffg
瞋	hfhw
睹	hfjg
睦	hfwf
盹	hgbn
睛	hgeg
盱	hsh
眄	hghn
凸	hghg
睐	hgoy
睫	hgvh
上	hhgg
止	hhhg
目	hhhh
卡	hhu
𨟠	hhwb
矍	hhwc
氍	hhwn
瞿	hhwo
眦	hhxn
卜	hhy
督	hich
叔	hicy
颦	hidf
频	hidm
睄	hieg
瞠	hipf
眺	hqiy
步	hir
眇	hitt
旧	hjg
卓	hjj
逴	hjpk
桌	hjsu
战	hkay
占	hkf
觇	hkmq
乩	hknn
点	hkou
卣	hlnf
鹾	hlqa
卤	hlqi
𪾢	hmqn
贞	hmu
眠	hnan
瞰	hnbt
颅	hndm
鼎	hndn
卢	hne
鸬	hnqg
瞩	hnty
忐	hnu
瞵	hoqh
䁖	hovg
眯	hoy
瞎	hpdk
壑	hpgf
睿	hpgh
瞑	hpju
眈	hpqn
餐	hqce
粲	hqco
睎	hqdh
瞻	hqdy
眵	hqqy
盷	hqug
睁	hqvh
睥	hrtf
瞟	hsfi
盯	hsh
瞫	hsjh
眊	htfn
睡	htgf
瞅	htoy
眨	htpy
瞳	hujf
睇	huxt
眼	hvey
瞍	hehc
睨	heqn
龄	hwbc
龈	hwbe
龌	hwbf
龃	hwbg
龊	hwbl
𬺓	hwbh
齿	hwbj
𬹼	hwbj
龉	hwbk
龆	hwbk
𬺈	hwbk
龅	hwbn
龁	hwbn
𫠜	hwbq
龂	hwbr
龀	hwbx
龇	hwbx
龋	hwby
睽	hogd
睑	hwgi
瞪	hogu
具	hwu
盼	hwvn
睢	hwog
瞧	hwoo
些	hxff
赀	hxmu
此	hxn
觜	hxqh
𫚖	hxpf
柴	hxsu
雌	hxwo
紫	hxxi
訾	hxyf
眩	hyxy
漭	iada
湛	iadn
澌	iadr
淇	iadw
潵	iaet
泔	iafg
江	iag
洭	iagg
懑	iagn
满	iagw
漠	iajd
灌	iako
潢	iamw
汇	ian
泄	iann
渠	ians
渫	ians
潆	iapi
涝	iapl
溁	iaps
滢	iapy
鸿	iaqg
沤	iaqy
柒	iasu
浇	iatq
潇	iavj
沏	iavt
濩	iawc
溚	iawk
港	iawn
洪	iawy
滠	ibcc
洱	ibg
滍	ibhj
涵	ibib
凼	ibk
泐	iblt
池	ibn
氾	ibn
漋	ibtg
滁	ibww
泾	icag
潏	icnk
滪	icnm
渗	icde
涌	iceh
泽	icfh
治	ickg
沇	icqn
涘	ictd
浚	icwt
滩	icwo
汉	icy
溞	icyj
汊	icyy
湖	ideg
洧	ideg
涯	idff
溽	idff
洿	idfn
沽	idg
滟	idhc
沣	idhh
尜	idiu
淹	idjn
沥	idlt
湎	idmd
𬇕	idnt
源	idri
涛	idtf
尖	idu
潦	idui
㵐	iduw
溱	idwt
泷	idxy
㳚	idyy
汰	idyy
浮	iebg
淝	iecn
淜	ieeg
肖	ief
湲	iefc
沮	iegg
削	iejh
逍	iepd
淫	ietf
滔	ieeg
溪	iexd
汲	ieyy
涿	ieyy
灞	ikae
𣸣	ifam
溘	ifcl
法	ifcy
沄	ifcg
濡	ikdj
尘	iff
洼	iffg
汁	ifh
汗	ifh
滇	ifhw
潮	ifje
汫	ifjh
瀚	ifjn
澎	ifke
澍	ifkf
洁	ifkg
渎	ifnd
𣲗	ifnh
污	ifnn
浡	ifpb
瀔	ifpc
溹	ifpi
渤	ifpl
沅	ifqn
𣲘	ifqn
涍	ifbg
渚	ifjg
洘	ifgn
漖	ifbt
澪	ikwc
潜	ifwj
汧	igah
沌	igbn
添	igdi
溥	igef
清	igeg
浦	igey
汪	igg
潖	iggc
沔	ighn
漹	igho
洹	igjg
浭	igjq
浯	igkg
滞	igkh
滆	igkh
涑	igki
濑	igkm
漱	igkw
沛	igmh
洓	igmi
漕	igmj
渍	igmy
溍	igoj
涞	igoy
洌	igqj
沫	igsy
浅	ifxy
泙	iguf
浃	igud
澽	ihae
滹	ihah
滤	ihan
婆	ihcv
波	ihcy
泪	ihg
沚	ihg
灈	ihho
淑	ihic
濒	ihim
涉	ihit
渺	ihit
淖	ihjh
沾	ihkg
浈	ihmy
泸	ihnt
瀣	ihqg
小	ihty
濉	ihwo
泚	ihxn
消	iieg
水	iiii
淼	iiiu
淌	iimk
洮	iqiy
洸	iiqn
裟	iite
鲨	iitg
挲	iitr
沙	iitt
娑	iitv
瀑	ijai
沓	ijf
涅	ijfg
浬	ijfg
汩	ijg
汨	ijg
淏	ijgd
湜	ijgh
浉	ijgh
滉	ijiq
漫	ijlc
温	ijlg
溻	ijng
湿	ijog
渴	ijqn
滥	ijtl
混	ijxx
浊	ijy
灏	ijym
浥	ikcn
涓	ikeg
呇	ikf
潞	iltk
溃	ikhm
浞	ily
渑	ikjn
漶	ikkn
澡	ikks
涡	ikmw
涢	ikmy
潩	ilaw
涸	ildg
瀱	ildj
洇	ildy
渭	ileg
溷	iley
涠	ilfh
泗	ilg
沺	ilg
澴	ilge
淠	ilgj
𬇹	ilgy
洄	ilkg
泇	ilkg
涟	ilpy
渐	ilrh
泅	ilwy
漯	ilxi
澧	imau
淟	imaw
没	imcy
湍	imdj
泱	imdy
滑	imeg
油	img
洞	imgk
涄	imgn
溅	imfy
溦	imgt
澂	imgt
汕	imh
测	imjh
尚	imkf
沿	imkg
泂	imkg
氅	imkn
敞	imkt
漴	impi
沨	imqy
涔	imwn
汭	imwy
漼	imwo
𬇙	imy
湣	inaj
泯	inan
潺	inbb
澉	inbt
汛	infh
漏	inky
渥	ingf
汈	ingg
湑	inhe
湄	inhg
澼	inkf
涮	inmj
汜	inn
烫	inro
汤	inrt
𬍡	inry
湉	intd
泌	intt
泼	inty
漻	inwe
濯	inwo
泥	inxn
沁	iny
浕	inyu
瀵	iolw
淡	iooy
潾	ioqh
溇	iovg
洣	ioy
黉	ipaw
学	ipbf
敩	ipbt
𬒈	ipdf
浓	ipey
尝	ipfc
淙	ipfi
浣	ipfq
泻	ipgg
渲	ipgg
淀	ipgh
演	ipgw
溟	ipju
䣘	ipkb
裳	ipke
堂	ipkf
常	ipkh
赏	ipkm
党	ipkq
掌	ipkr
棠	ipks
牚	ipkt
浑	iplh
峃	ipmj
沉	ipmn
觉	ipmq
涫	iphn
涴	ipqb
鲎	ippf
沈	ipqn
滨	iprw
泞	ipsh
喾	iprk
滓	ipuf
溶	ipwk
滘	ipwk
深	ipws
沱	ipxn
泜	iqay
光	iqb
汹	iqbh
沟	iqcy
洈	iqdb
淆	iqde
浠	iqdh
𫖯	qidm
澹	iqdy
澥	iqeh
鼗	iqfc
淦	iqg
渔	ipg
澛	ipjg
泺	iqiy
洵	iqjg
泃	iqkg
洺	iqkg
浼	iqkq
涣	iqmd
泡	iqnn
耀	iqno
辉	iqpl
逃	qipi
淘	iqrm
淴	iqrn
泖	iqtb
潴	iefj
漪	iedk
兆	qii
㴔	iqvn
汐	iqy
溜	iqyl
汋	iqyy
湃	irdf
派	irey
泊	irg
湟	irgg
浜	irgw
沂	irh
洙	iriy
汽	irnn
浙	irrh
溵	irvc
激	irot
湮	isfg
漂	isfi
洒	isg
酒	isgg
汀	ish
湘	ishg
渣	isjg
潭	isjh
河	iskg
淅	isrh
潸	isse
濋	issw
漤	issv
淋	issy
溧	issy
淞	iswc
漆	iswi
沐	isy
沭	isyy
洚	itah
活	itdg
浲	itdh
鋈	itdq
沃	itdy
浩	irkg
洗	irqn
溴	ithd
省	ithf
洎	ithg
濞	ithj
涎	ithp
潲	itie
浰	itjh
洛	itkg
劣	itlr
洫	itlg
澳	itmd
汔	itnn
渊	itoh
潘	itol
湫	itoy
泛	itpy
少	itr
涐	itry
涤	itsy
滗	ittn
海	itxu
洴	iuah
溯	iube
滚	iuce
溠	iuda
洋	iudh
湔	iuej
泮	iufh
泣	iug
渼	iugd
润	iugg
漾	iugi
澜	iugi
潼	iujf
涧	iujg
漳	iujh
涪	iukg
滴	iumd
湴	iuog
潽	iuoj
滂	iupo
滧	iuqt
洨	iuqy
浐	iutt
溢	iuwl
涕	iuxt
滋	iuxx
溉	ivcq
当	ivf
津	ivfh
浔	ivfy
汝	ivg
溲	iehc
渌	iviy
沼	ivkg
洳	ivkg
淄	ivlg
氿	ivn
浸	ivpc
潟	ieqo
染	ivsu
粱	ivwo
梁	ivws
涩	ivyh
沧	iwbn
滃	iwcn
洑	iwdy
脊	iwef
鹡	iweg
浍	iwfc
举	iwfh
漈	iwfi
渰	iwga
瀹	iwga
㽏	iwgf
渝	iwgj
洽	iwgk
潋	iwgt
澄	iogu
滫	iwhe
浟	iwht
濮	iwow
滏	iwqu
㳇	iwqy
溆	iwsc
涂	iwsw
兴	iwu
湓	iwvl
汾	iwvt
洢	iwvt
浴	iwwk
沦	iwxn
泠	iwyc
雀	iwof
誉	iwyf
淮	iwog
浛	iwyk
泓	ixcy
沸	ixjh
涨	ixty
溺	ixuu
潍	ixwo
沘	ixxn
湝	ixxr
渡	iyac
漷	iybb
漓	iybc
淳	iybg
淯	iyce
流	iyck
鎏	iycq
㳘	iycq
澈	iyct
瑬	iycy
注	iygg
汴	iyhy
瀍	iyjf
浏	iyjh
济	iyjh
瀼	iyke
澶	iylg
沩	iyly
沆	iymn
泳	iyni
瀌	iyno
沪	iynt
漉	iynx
瀛	iyny
滦	iyos
湾	iyox
濠	iype
渟	iyps
游	iotb
浒	iytf
洲	iyth
漩	ioth
濂	iyuo
浪	iyve
溏	iyvk
淬	iywf
淤	iowu
液	iywy
泫	iyxy
澭	iyxo
汶	iyy
蟒	jada
蜞	jadw
蚶	jafg
虹	jag
螨	jagw
蚜	jaht
𬟽	jaiy
蟆	jajd
蜡	jajg
蝘	jajv
蜮	jakg
暵	jakw
蟥	jamw
蝶	jans
蠓	jape
蝾	japs
晓	jatq
蛲	jatq
蟏	javj
蠖	jawc
暴	jawi
最	jbcu
虸	jbg
蜢	jblg
昪	jcaj
肾	jcef
蛹	jceh
坚	jcff
蛏	jcfg
蚂	jcg
贤	jcmu
蚆	jcn
蛑	jcrh
竖	jcuf
晙	jcwt
紧	jcxi
蛎	jddn
蝴	jdeg
晨	jdfe
蝰	jdff
蛄	jdg
蚌	jdhh
晟	jdny
螈	jdri
蝽	jdwj
昃	jdwu
昽	jdxy
蜉	jebg
暖	jefc
㬊	jefc
明	jeg
蛆	jegg
盟	jelf
曌	jepa
暧	jepc
野	jfch
墅	jfcf
蜐	jfcl
昙	jfcu
里	jfd
蠕	jkdj
蛙	jffg
旰	jfh
虷	jfh
昧	jfiy
旱	jfj
蟛	jfke
暿	jfkk
蝻	jfmf
𬀩	jfnh
暑	jfjf
蚨	jfwy
时	jfy
蛭	jgcf
晊	jgcf
昊	jgdu
晴	jgeg
蜻	jgeg
晡	jgey
旦	jgf
旴	jsh
旺	jgg
韪	jghh
题	jghm
是	jghu
匙	jghx
虾	jghy
量	jgjf
晅	jgjg
蟪	jgjn
晤	jgkg
䗖	jgkh
蝲	jgkj
蝠	jgkl
暕	jgli
师	jgmh
螬	jgmj
昺	jgmw
蛃	jgmw
蚲	jguf
蛱	jgud
冒	jhf
蠼	jhhc
晫	jhjh
申	jhk
勖	jhlt
曰	jhng
早	jhnh
畅	jhnr
虫	jhny
蛸	jieg
螳	jipf
晃	jiqb
晁	jiqb
曝	jjai
昌	jjf
蛳	jjgh
晶	jjjf
日	jjjj
蝎	jjqn
蜴	jjqr
蜾	jjsy
蜎	jkeg
蜈	jkgd
冔	jksj
蝇	jkjn
蜗	jkmw
曼	jlcu
蛊	jlf
曙	jlfj
蝈	jlgy
蛔	jlkg
蠋	jlqj
螺	jlxi
蛐	jmag
晪	jmaw
映	jmdy
蚺	jmfg
蜩	jmfk
蚰	jmg
帅	jmhh
颙	jmhm
愚	jmhn
遇	jmhp
禺	jmhy
旵	jmj
虮	jmn
蚬	jmqn
𬀪	jmqn
蚋	jmwy
暅	jngg
暇	jnhc
虬	jnn
遢	jnpd
旸	jnrt
电	jnv
曜	jnwo
昵	jnxn
显	jogf
晱	jooy
炅	jou
蝼	jovg
暄	jpgg
暝	jpju
螟	jpju
晖	jplh
晕	jplj
蜿	jpqb
晏	jpvf
蛇	jpxn
昂	jqbj
晞	jqdh
蟾	jqdy
昫	jqkg
煦	jqko
晚	jqkq
冕	jqkq
剔	jqrj
易	jqrr
昒	jqrt
昴	jqtb
昀	jqug
鹖	jqwg
曷	jqwn
遏	jqwp
歇	jqww
昄	jrcy
蚯	jrgg
蝗	jrgg
昕	jrh
蛛	jriy
蜱	jrtf
昳	jrwy
颗	jsdm
螵	jsfi
晒	jsg
果	jsi
蟫	jsjh
夥	jsqq
晰	jsrh
蜥	jsrh
杲	jsu
昇	jtaj
蛞	jtdg
蜂	jtdh
蜘	jtdk
旿	jtfh
蚝	jtfn
蜓	jtfp
戥	jtga
星	jtgf
曛	jtgo
昨	jthf
蚱	jthf
晷	jthk
螅	jthn
蜒	jthp
蜊	jtjh
蝮	jtjt
晌	jtmk
虼	jtnn
蟠	jtol
蟋	jton
蛾	jtry
䗴	jttp
蝌	jtuf
晦	jtxu
临	jtyj
监	jtyl
览	jtyq
鉴	jtyq
蜷	judb
蛘	judh
蟮	judk
蜣	judq
昱	juf
蚪	jufh
曦	jugy
蝉	jujf
曈	jujf
暗	jujg
蟑	jujh
暲	jujh
蜕	jukq
螃	jupo
蛟	juqy
蝤	jusg
螠	juwl
旯	jvb
归	jvg
螋	jehc
昭	jvkg
照	jvko
蚣	jwcy
昣	jwet
暌	jogd
蝓	jwgj
蛤	jwgk
䗛	jwhe
蚧	jwjh
蜍	jwsw
晔	jwxf
蛉	jwyc
昤	jwyc
晗	jwyk
暹	jwop
曳	jxe
蚓	jxhh
蚴	jxlt
昆	jxxb
鹍	jxxg
蚍	jxxn
㬎	jxxo
螭	jybc
暾	jybt
㬚	jyct
蛀	jygg
影	jyie
颢	jyim
景	jyiu
晾	jyiy
蛴	jyjh
曩	jyke
昉	jot
蚄	jot
蝙	jyna
虻	jynn
昈	jynt
晐	jynw
蚁	jyqy
旷	jyt
蝣	jotb
暶	joth
旻	jyu
蠊	jyuo
螂	jyvb
㫰	jyve
螗	jyvk
蟀	jyxf
昡	jyxy
蚊	jyy
喏	kadk
嘶	kadr
嘞	kakl
哐	kagg
呀	kaht
噶	kajn
喵	kalg
咂	kamh
唝	kamy
呓	kann
喋	kans
唠	kapl
呕	kaqy
哎	kaqy
哓	katq
嚄	kawc
嗒	kawk
嗬	kawk
哄	kawy
嚆	kayk
嗫	kbcc
咡	kbg
叩	kbh
嗤	kbhj
咄	kbmh
吼	kbnn
戢	kbxy
啊	kbsk
邑	kcb
啜	kccc
嗓	kccs
嗵	kcep
吗	kcg
咍	kckg
吧	kcn
吮	kcqn
哞	kcrh
唉	kctd
唆	kcwt
叹	kcy
呃	kdbn
喹	kdff
咕	kdg
喊	kdgy
嘎	kdha
嗄	kdht
嘁	kdhy
啡	kjdd
喱	kdjf
唵	kdjn
呖	kdlt
顺	kdmy
咴	kdoy
哒	kdpy
𠳐	kdtb
嘹	kdui
噘	kduw
唪	kdwh
嗪	kdwt
咙	kdxy
吠	kdy
呔	kdyy
咀	kegg
嚼	kelf
嗳	kepc
鹃	keqg
吸	keyy
啄	keyy
喷	kfam
嗑	kfcl
吱	kfcy
嚅	kkdj
哇	kffg
吐	kfg
叶	kfh
嗔	kfhw
味	kfiy
嘲	kfje
嘭	kfke
嘻	kfkk
鄙	kflb
喃	kfmf
哧	kfoy
哱	kfpb
嚏	kfph
嗦	kfpi
噎	kfpu
呒	kfqn
哮	kfbg
嘟	kfjb
嗜	kfxj
啫	kfjg
呋	kfwy
嚯	kkwo
哢	kgah
郢	kgbh
吨	kgbn
咥	kgcf
吴	kgdu
哺	kgey
呈	kgf
吁	ksh
吓	kghy
呸	kdhg
咺	kgjg
哽	kgjq
囔	kfke
唔	kgkg
嗝	kgkh
喇	kgkj
嗽	kgkw
嘈	kgmj
啧	kgmy
号	kgnb
饕	kgne
鸮	kgng
哑	kgog
逞	kgpd
咧	kgqj
嗷	kgqt
唛	kgty
嗉	kgxi
咦	kgxw
噱	khae
嘘	khag
躇	lafj
唬	kham
距	lang
跷	latq
蹀	lans
蹒	lagw
躏	lauo
蹑	lbcc
踊	lceh
跆	lckg
蹂	lcns
跋	ldcy
踌	ldtf
蹰	ldgf
跖	ldg
蹽	ldui
踦	ldsk
跨	ldfn
跶	ldpi
蹶	lduw
蹊	lexd
啃	kheg
踩	lesy
蹈	leeg
趿	leyy
跂	lfcy
跬	lffg
跱	lffy
趺	lfwy
趼	lgah
贵	khgm
遗	khgp
遣	khgp
践	lfxy
跛	lhcy
趾	lhg
踔	lhjh
跐	lhxn
咔	khhy
蹐	liwe
蹚	lipf
踏	lijg
跳	lqiy
踶	ljgh
蹋	ljng
踢	ljqr
踝	ljsy
中	khk
躁	lkks
盅	khlf
躅	llqj
跏	llkg
蹦	lmee
跚	lmmg
踹	lmdj
跺	lmsy
踞	lndg
跽	lnny
忠	khnu
躞	lyoc
蹼	logw
蹿	lpwh
踪	lpfi
蹜	lpwj
跎	lpxn
跪	lqdb
跞	lqiy
跑	lqnn
趵	lqyy
踬	lrfm
跌	lrwy
蹅	lsjg
跃	ltdy
踵	ltgf
鹭	ltkg
路	ltkg
踟	ltdk
蹯	ltol
躜	lrqm
跹	ltfp
跣	lrqn
踒	ltvy
踽	ltky
足	lhny
蹉	luda
踯	ludb
蹢	lumk
蹲	lusf
蹄	luph
蹭	lulj
踣	lukg
跤	luqy
跟	lvey
躐	lvln
踺	lvfp
啮	khwb
跄	lwbn
跗	lwfy
蹬	logu
趴	lwy
嘴	khxh
跸	lxxf
呲	khxn
𧿹	lxgu
卟	khy
蹁	lyna
踱	lyac
踉	lyve
躔	lyjf
跻	lyjh
踮	lyhk
蹴	lyin
蹾	lybt
哨	kieg
啵	kihc
唢	kimy
嘡	kpkf
咣	kiqn
吵	kitt
嗨	kitu
嘬	kjbc
哩	kjfg
呻	kjhh
唱	kjjg
喁	kjmy
黾	kjnb
𫑡	kjnb
喝	kjqn
虽	kju
嚚	kkak
骂	kkcf
器	kkdk
嚣	kkdk
哭	kkdu
吕	kkf
鄂	kkfb
鹗	kkfg
颚	kkfm
串	kkhk
患	kkhn
品	kkkf
口	kkkk
噪	kkks
鼍	kkln
咒	kkmb
斝	kkpf
另	klr
嗯	kldn
咽	kldy
喟	kleg
嘿	klfo
啭	klfy
喂	klge
呷	klh
别	kljh
咖	klkg
叻	klt
啰	klqy
嗣	kmak
郧	kmbh
喘	kmdj
咉	kmdy
嘣	kmee
啁	kmfk
哃	kmgk
吊	kmhj
勋	kmlt
嘤	kmmv
叽	kmn
哕	kmqy
哚	kmsy
员	kmu
剐	kmwj
呙	kmwu
呐	kmwy
呗	kmy
喔	kngf
叼	kngg
叫	knhh
噼	knkf
唰	knmj
噀	knnw
咇	kntt
嘱	knty
呢	knxn
吣	kny
噗	kogw
啖	kooy
喽	kovg
咪	koy
嗐	kpdk
哝	kpey
噻	kpff
喧	kpgg
啶	kpgh
嘧	kpnm
咛	kpsh
咤	kpta
喀	kptk
嚓	kpwi
兄	kqb
唏	kqdh
噜	kpjg
史	kqi
唤	kqmd
呜	kqng
咆	kqnn
哆	kqqy
啕	kqrm
唿	kqrn
吻	kqrt
吹	kqwy
鸣	kqyg
唣	kran
呱	krcy
嗥	krdf
哌	krey
喤	krgg
听	krh
吽	krhh
啪	krrg
哳	krrh
啤	krtf
啦	krug
嘌	ksfi
哂	ksg
叮	ksh
喳	ksjg
呵	kskg
噤	kssi
啉	kssy
呆	ksu
吒	ktan
噬	ktaw
唾	ktgf
嗅	kthd
咋	kthf
咱	kthg
川	kthh
嘚	ktjy
咯	ktkg
噢	ktmd
响	ktmk
吃	ktnn
啾	ktoy
哦	ktry
呼	ktuf
咚	ktuy
嗍	kube
嗟	kuda
咩	kudh
吖	kuhh
啴	kujh
噇	kujf
喑	kujg
噫	kujn
噌	kulj
嘀	kumd
㘎	kunt
啼	kuph
咬	kuqy
噂	kusf
唼	kuvg
嗌	kuwl
嗞	kuxx
唧	kvcb
呶	kvcy
哏	kvey
哪	kvfb
嗖	kehc
啸	kvij
叨	kvt
呛	kwbn
嗡	kwcn
哙	kwfc
啥	kwfk
咐	kwfy
喻	kwgj
哈	kwgk
噔	kogu
喉	kwnd
嗲	kwqq
㕮	kwqy
咻	kwsy
只	kwu
吩	kwvt
咿	kwvt
唑	kwwf
哗	kwxf
叭	kwy
呤	kwyc
噙	kwyc
唯	kwog
吟	kwyn
噍	kwoo
喙	kxey
呣	kxgu
吲	kxhh
呦	kxlt
叱	kxn
哟	kxqy
哔	kxxf
咝	kxxg
吡	kxxn
喈	kxxr
吆	kxy
哼	kybh
唷	kyce
唁	kyg
嚷	kyke
吭	kymn
唳	kynd
咏	kyni
咳	kynw
嚎	kype
嘛	kyss
嗾	kotd
啷	kyvb
啐	kywf
轼	laag
羁	lakc
墼	gjff
辄	lbnn
轻	lcag
𫐓	lcns
辍	lccc
轰	lccu
畯	lcwt
轭	ldbn
固	ldd
囿	lded
罟	ldf
轱	ldg
因	ldi
罪	ljdd
罨	ldjn
恩	ldnu
罽	ldoj
畸	ldsk
畴	ldtf
辏	ldwd
畎	ldy
轪	ldy
胃	lef
罴	lfco
罢	lfcu
畦	lffg
畤	lffy
轩	lfh
置	lfhf
辕	lfke
罱	lfmf
围	lfnh
转	lfny
默	lfod
黩	lfod
黪	lfoe
墨	lfof
黥	lfoi
黯	lfoj
黠	lfok
黝	lfol
黜	lfom
黔	lfon
黟	lfoq
黢	lfot
黑	lfou
园	lfqv
团	lfte
署	lfjf
圉	lfuf
囤	lgbn
轾	lgcf
圊	lged
畏	lgeu
圃	lgey
辅	lgey
罡	lghf
罘	ldhu
畀	lgjj
圄	lgkd
鹮	lgkg
辐	lgkl
翾	lgkn
辆	lgmw
车	lgnh
𫐄	lgqn
国	lgyi
罩	lhjj
皿	lhng
四	lhng
甲	lhnh
轳	lhnt
𨐈	liqn
辒	ljlg
辊	ljxx
辑	lkbg
驾	lkcf
回	lkd
加	lkg
圆	lkmi
贺	lkmu
迦	lkpd
哿	lksk
架	lksu
轵	lkwy
袈	lkye
男	llr
圜	llge
田	llll
罍	lllm
勰	llln
圐	lloe
圌	lmdj
轴	lmg
辋	lmun
辗	lnae
翈	lng
轧	lnn
思	lnu
疁	lnwe
罹	lnwo
辚	loqh
辖	lpdk
连	lpk
畹	lpqb
边	lpe
𬨂	lqan
轹	lqiy
蜀	lqju
逻	lqpi
囫	lqre
罗	lqu
软	lqwy
鸭	lqyg
罶	lqyl
畈	lrcy
畖	lrcy
堑	lrff
斩	lrh
暂	lrjf
錾	lrqf
椠	lrsu
轶	lrwy
町	lsh
困	lsi
轲	lskg
轿	ltdj
辀	ltey
囷	lti
略	ltkg
辂	ltkg
力	lnt
轷	ltuf
图	ltui
畋	lty
圈	ludb
𫟦	luep
畔	lufh
疃	lujf
罾	lulj
较	luqy
𬨎	lusg
囡	lvd
轺	lvkg
辎	lvlg
轨	lvn
𫐐	leqn
轫	lvyy
圙	lwdd
轸	lwet
畛	lwet
辁	lwgg
输	lwgj
办	lwi
囚	lwi
界	lwjj
轮	lwxn
囵	lwxv
囹	lwyc
累	lxiu
毗	lxxn
辙	lyct
詈	lyf
辌	lyiy
罚	lyjj
辘	lynx
曲	mad
嵁	madn
贼	madt
嵌	mafw
岈	maht
岽	maiu
岠	mang
㠓	mape
崂	mapl
嵘	maps
岖	maqy
峣	matq
典	mawu
邮	mbh
崡	mbib
岜	mcb
峄	mcfh
凤	mci
贻	mckg
殳	mcu
峻	mcwt
贿	mdeg
岩	mdf
赈	mdfe
崖	mdff
岸	mdfj
岵	mdg
崴	mdgy
嵅	mdgy
央	mdi
崦	mdjn
𫵷	mdlt
盎	mdlf
𪨶	mdlj
耑	mdjj
颛	mdmm
遄	mdmp
𬱖	mdmy
炭	mdou
鸯	mdqg
崎	mdsk
骷	medg
髓	medp
崩	meef
骨	mef
胄	mef
岨	megg
髁	mejs
髃	mejy
髑	melj
骰	memc
髎	mene
髅	meov
髂	mepk
髋	mepq
髌	mepw
鹘	meqg
骶	meqy
髀	merf
骺	merk
骼	metk
骱	mewj
岌	meyu
骸	meyw
岐	mfcy
冉	mfd
崶	mfff
峙	mffy
巅	mfhm
赇	mfiy
周	mfkd
雕	mfko
𪩘	mfmd
赎	mfnd
䎃	mfng
崁	mfqw
赌	mfjg
财	mftt
崚	mfwt
赋	mgah
岍	mgah
赙	mgef
峘	mgjg
同	mgkd
峿	mgkg
𫶇	mgkh
屿	mgng
崃	mgoy
夙	mgqi
峛	mgqj
屼	mgqn
贱	mfxy
峡	mgud
巇	mhaa
幪	mhae
帱	mhdf
帏	mhfh
幅	mhgl
帻	mhgm
帔	mhhc
帖	mhhk
帧	mhhm
幔	mhjc
帽	mhjh
幌	mhjq
巾	mhk
贴	mhkg
帜	mhkw
帼	mhly
帆	mhmy
幄	mhnf
由	mhng
贝	mhny
幞	mhow
帕	mhrg
帙	mhrw
幖	mhsi
幡	mhtl
帐	mhty
帡	mhua
幢	mhuf
幛	mhuj
帨	mhuq
帷	mhwo
峭	mieg
嵴	miwe
则	mjh
赗	mjhg
嵎	mjmy
赐	mjqr
岿	mjvf
崿	mkkn
迥	mkpd
贶	mkqn
崮	mldf
岬	mlh
崽	mlnu
崭	mlrj
𪨰	mmag
赒	mmfk
岫	mmg
凹	hnmg
册	mmgd
删	mmgj
峒	mmgk
兕	mmgq
屾	mmh
山	mmmm
赑	mmmu
岘	mmqn
岗	mmqu
岚	mmqu
罂	mmrm
婴	mmvf
鹦	mmvg
岷	mnan
岂	mnb
崛	mnbm
崌	mndg
𫖮	mndm
㟃	mngk
嵋	mnhg
剀	mnjh
凯	mnmn
觊	mnmq
屺	mnn
嶍	mnrg
赆	mnyu
赕	mooy
嶙	moqh
嵝	movg
迪	mpd
崇	mpfi
贮	mpgg
辿	mpk
崆	mpwa
见	mqb
觃	mqbd
购	mqcy
峗	mqdb
崤	mqde
赡	mqdy
嶦	mqdy
崟	mqf
飐	mqhk
飓	mqhw
冈	mqi
风	mqi
峋	mqjg
刚	mqjh
刿	mqjh
岣	mqkg
巉	mqky
飔	mqln
翙	mqng
飏	mqnr
网	mqqi
飗	mqql
飑	mqqn
嵚	mqqw
峁	mqtb
岁	mqu
飕	mqec
峥	mqvh
贩	mrcy
凰	mrgd
嵬	mrqc
嵖	msjg
剁	msjh
岢	mskf
朵	msu
崾	msvg
崧	mswc
账	mtay
峰	mtdh
峤	mtdj
岞	mthf
嵲	mths
赂	mtkg
几	mtn
屹	mtnn
嶓	mtol
贬	mtpy
峨	mtry
嵊	mtux
峂	mtuy
巍	mtvc
败	mty
嵯	muda
嶂	mujh
赔	mukg
赠	mulj
嶒	mulj
峧	muqy
嶟	musf
赚	muvo
嵫	muxx
罔	muyn
赊	mwfi
崄	mwgi
嵛	mwgj
嶝	mogu
内	mwi
冏	mwkd
肉	mwwi
峪	mwwk
酅	mwob
岭	mwyc
崔	mwof
嶲	mwom
岑	mwyn
嶷	mxth
崞	mybg
丹	myd
彤	myet
赃	myfg
凡	myi
㠇	myiy
嵩	mymk
赅	mynw
崀	myve
崒	mywf
悈	naah
展	naei
惬	nagw
异	naj
羿	naj
惜	najg
慬	nakg
懵	nalh
屉	nanv
怄	naqy
懂	natf
愍	natn
民	nav
殿	nawc
臀	nawe
慌	nayk
孱	nbbb
慑	nbcc
屈	nbmk
屙	nbsk
憨	nbtn
敢	nbty
惙	nccc
惨	ncde
怪	ncfg
怿	ncfh
怡	nckg
悛	ncwt
惰	ndae
居	ndd
恹	nddy
怙	ndg
憾	ndgn
悱	njdd
剧	ndjh
愐	ndmd
怖	ndmh
忧	ndny
恢	ndoy
憭	ndui
慆	neeg
愤	nfam
层	nfci
厾	nfci
恸	nfcl
怯	nfcy
忮	nfcy
丑	nfd
懦	nkdj
恃	nffy
慎	nfhw
尉	nfif
螱	nfij
慰	nfin
熨	nfio
悖	nfpb
迅	nfpk
怃	nfqn
屠	nfjd
愭	nfxj
导	nfu
悻	nfuf
㥄	nfwt
忖	nfy
忳	ngbn
屋	ngcf
刁	ngd
情	ngeg
怔	nghg
怀	ndhy
恒	ngjg
司	ngkd
悟	ngkg
悚	ngki
懒	ngkm
怦	nguf
愫	ngxi
郿	nhbh
眉	nhd
戕	nhda
奘	nhdd
牂	hndd
爿	nhde
牁	nhdk
胥	nhef
叚	nhfc
遐	nhfp
疍	nhjg
悼	nhjh
蛋	nhju
鹛	nhqg
收	nhty
惧	nhwy
疏	nhyk
屑	nied
悄	nieg
尿	nii
惝	nimk
恍	niqn
犀	nirh
悭	njcf
悝	njfg
悍	njfh
怛	njgg
慢	njlc
愠	njlg
惕	njqr
惺	njtg
憬	njyi
悒	nkcn
忡	nkhh
翀	nkhh
愦	nkhm
愕	nkkn
臂	nkue
襞	nkue
壁	nkuf
䴙	nkug
辟	nkuf
甓	nkuy
避	nkup
鐾	nkuq
擘	nkur
檗	nkus
劈	nkuv
嬖	nkuv
璧	nkuy
譬	nkuy
翼	nlaw
惭	nlrh
悃	nlsy
愣	nlot
届	nmd
惴	nmdj
怏	nmdy
惆	nmfk
恫	nmgk
刷	nmhj
屃	nmi
恻	nmjh
恺	nmnn
惘	nmun
巽	nnaw
忸	nnfg
己	nnnn
巳	nngn
尸	nngt
书	nnhy
局	nnkd
乙	nnll
忆	nnn
已	nngn
忌	nnu
乜	nnv
快	nnwy
怩	nnxn
羽	nnyg
屎	noi
惔	nooy
屡	novd
悰	npfi
愃	npgg
恽	nplh
翚	nplj
惋	npqb
忱	npqn
惛	nqaj
憺	nqdy
懈	nqeh
恂	nqjg
惚	nqrn
㤘	nqvg
忺	nqwy
鸤	nqyg
怕	nrg
惶	nrgg
忻	nrh
忾	nrnn
愧	nrqc
恓	nsg
憷	nssh
怵	nsyy
怅	ntay
悸	ntbg
邲	ntbh
发	ntcy
恬	ntdg
必	nte
屐	ntfc
忏	ntfh
忤	ntfh
尾	ntfn
慥	nrkp
性	ntgg
怍	nthf
屣	nthh
虱	ntji
愎	ntjt
恪	ntkg
属	ntky
恤	ntlg
懊	ntmd
屦	ntov
愀	ntoy
履	nttt
悔	ntxu
改	nty
屏	nuak
习	nud
羼	nudd
买	nudu
翌	nuf
飞	nui
惮	nujf
憧	nujf
愔	nujg
悦	nukq
憎	nulj
恔	nuqy
慊	nuvo
悌	nuxt
悯	nuyy
慨	nvcq
恨	nvey
怊	nvkg
忉	nvt
尻	nvv
怆	nwbn
忪	nwcy
戮	nwea
鹨	nweg
勠	nwel
愉	nwgj
恰	nwgk
憕	nogu
夬	nwi
翂	nwvt
戳	nwoa
怜	nwyc
翟	nwof
惟	nwog
憔	nwoo
惯	nxfm
怫	nxjh
尼	nxv
屁	nxxv
惇	nybg
恼	nybh
惦	nyhk
忭	nyhy
尺	nyi
惊	nyiy
昼	nyjg
咫	nykw
懔	nyli
翯	nymk
忙	nynn
心	nyny
迟	nypi
尽	nyuu
悢	nyve
慵	nyvh
慷	nyvi
悴	nywf
翠	nywf
以	nywy
煁	oadn
煤	oafs
爟	oako
炬	oang
炼	oanw
𬉼	oaqy
糒	oath
烧	oatq
粪	oawu
烘	oawy
籽	obg
烃	ocag
燏	ocnk
糅	ocns
糁	ocde
熥	ocep
粑	ocn
焌	ocwt
粝	oddn
糊	odeg
煳	odeg
烠	odeg
煃	odff
炻	odg
烦	odmy
类	odu
燎	odui
粗	oegg
㶲	oehh
爝	oelf
糯	okdj
灶	ofg
炜	ofnh
烤	ofgn
㸌	okwo
邺	ogbh
炖	ogbn
业	ogd
精	ogeg
烜	ogjg
粳	ogjq
焐	ogkg
糟	ogmj
炳	ogmw
凿	ogub
黻	oguc
黹	ogui
黼	oguy
焯	ohjh
粘	ohkg
炒	oitt
爆	ojai
焊	ojfh
炟	ojgg
煴	ojlg
粿	ojsy
煋	ojtg
煜	ojug
焜	ojxx
烛	ojy
焆	okeg
燥	okks
炽	okwy
烟	oldy
煟	oleg
煨	olge
煓	omdj
烔	omgk
灿	omh
籼	omh
炯	omkg
糈	onhe
焗	onnk
熠	onrg
断	onrh
炀	onrt
炔	onwy
烬	onyu
郯	oobh
剡	oojh
火	oooo
燚	oooo
燊	ooos
焱	ooou
欻	ooqw
炎	oou
粽	opfi
烷	opfq
煊	opgg
迷	opi
熔	opwk
粼	oqab
翷	oqan
遴	oqap
烯	oqdh
燃	oqdo
烁	oqiy
焕	oqmd
炮	oqnn
焰	oqeg
炊	oqwy
熘	oqyl
灼	oqyy
粕	org
煌	orgg
炘	orh
熛	osfi
粞	osg
灯	osh
𥻗	osjg
炣	oskg
烽	otdh
㸆	orkd
糙	orkp
烶	otfp
糗	othd
炸	othf
糌	othj
熄	othn
烻	othp
烙	otkg
熜	otln
燠	otmd
燔	otol
烀	otuf
敉	oty
烊	oudh
燧	ouep
烂	oudg
料	oufh
粒	oug
糕	ougo
爔	ougy
𬊤	oujh
焙	oukg
熵	oumk
焖	ouny
糍	ouxx
煺	ovep
娄	ovf
𬊈	ovfy
数	ovty
炝	owbn
煅	owdc
烩	owfc
爚	owga
熻	owgn
炌	owjh
糇	ownd
粉	owvt
烨	owxf
焓	owyk
燋	owoo
糨	oxkj
焞	oybg
炷	oygg
熇	oymk
炕	oymn
煸	oyna
煽	oynn
炉	oynt
燮	yooc
米	oyty
粮	oyve
烺	oyve
糠	oyvi
糖	oyvk
粹	oywf
炫	oyxy
炆	oyy
宦	pahh
宧	pahh
寞	pajd
宽	pamq
字	pbf
宏	pdcu
宥	pdef
寡	pdev
宕	pdf
宸	pdfe
割	pdhj
害	pdhk
豁	pdhk
宬	pdny
寄	pdsk
寮	pdui
宠	pdxy
宜	pegf
农	pei
家	peu
冢	peyu
宗	pfiu
骞	pfjc
褰	pfje
塞	pfjf
𬸣	pfjg
蹇	pfjh
赛	pfjm
搴	pfjr
寨	pfjs
寒	pfju
謇	pfjy
完	pfqb
寇	pfqc
冠	pfqf
守	pfu
室	pgcf
宇	psj
定	pghu
宣	pgjg
富	pgkl
戭	pgma
寅	pgmw
写	pgng
寁	pgvh
宝	pgyu
寂	phic
宵	pief
幂	pjdh
审	pjhj
寓	pjmy
冥	pjuu
宴	pjvf
宫	pkkf
郓	plbh
寰	plge
皲	plhc
军	plj
冗	pmb
宙	pmf
甯	pneh
寐	pnhi
寤	pnhk
官	phnn
逭	phnp
蜜	pntj
密	pntm
宓	pntr
寥	pnwe
灾	pou
之	pppp
宛	pqbb
剜	pqbj
冤	pqky
鸩	pqqg
宾	prgw
牢	prhj
宁	psj
宋	psu
宅	ptab
宪	prqb
客	ptkf
额	ptkm
褡	puak
裰	pucc
衩	pucy
褥	pudf
襫	pudj
实	pudu
衫	puet
袪	pufc
褂	pufh
袆	pufh
褚	pufj
襦	pukj
衬	pufy
裱	puge
𫌀	pugm
袜	pugs
被	puhc
补	puhy
裆	puiv
宰	pufj
袒	pujg
褴	pujl
褐	pujn
褟	pujn
裼	pujr
裸	pujs
裎	pukg
裢	pulp
袖	pumg
衲	pumw
裾	pund
褶	punr
袂	punw
袯	puny
褛	puov
裈	pupl
袍	puqn
襜	puqy
裨	purf
褫	purm
襟	pusi
襻	pusr
袄	putd
衽	putf
袼	putk
褙	puue
袢	puuf
襕	puui
裥	puuj
襚	puup
寝	puvc
裉	puve
裙	puvk
初	puvt
褪	puvp
袱	puwd
袗	puwe
裣	puwi
褕	puwj
裕	puwk
袷	puwk
衿	puwn
褓	puws
襁	puxj
褊	puya
褯	puyh
裤	puyl
宄	pvb
安	pvf
案	pvsu
空	pwaf
窍	pwan
穿	pwat
窃	pwav
窿	pwbg
宿	pwdj
突	pwdu
窦	pwfd
察	pwfi
罕	pwfj
窥	pwfq
窒	pwgf
窀	pwgn
窅	pwhf
窕	pwqi
窠	pwjs
窜	pwkh
窝	pwkw
穷	pwlr
帘	pwmh
窟	pwnm
窭	pwov
窎	pwqg
穸	pwqu
窑	pwrm
窳	pwry
窊	pwry
窄	pwtf
窖	pwrk
窸	pwtn
窗	pwtq
穴	pwu
窨	pwuj
邃	pwup
究	pwvb
窘	pwvk
窬	pwwj
容	pwwk
穹	pwxb
窈	pwxl
隺	pwod
窣	pwyf
鹤	pwog
它	pxb
祺	pyaw
祁	pybh
祃	pycg
祓	pydy
禊	pydd
祷	pydf
祜	pydg
祏	pydg
祐	pydk
祖	pyeg
祛	pyfc
社	pyfg
祎	pyfh
禧	pyfk
祾	pyft
禛	pyfw
祆	pygd
福	pygl
祉	pyhg
祯	pyhm
祧	pyqi
神	pyjh
禔	pyjh
祼	pyjs
祝	pykq
祸	pykw
禤	pyln
祋	pymc
视	pymq
祠	pynk
礼	pynn
祀	pynn
祕	pynt
祇	pyqa
祢	pyqi
祗	pyqy
祈	pyrh
禋	pysf
祚	pytf
祥	pyud
禅	pyuf
禘	pyuh
禚	pyuo
祲	pyvc
禄	pyvi
禒	pyxe
禳	pyye
祊	pyot
锘	qadk
𫓹	qadw
钳	qafg
䦃	qafj
铘	qahb
舛	qahh
桀	qahs
镆	qajd
昏	qajf
错	qajg
钷	qakg
锚	qalg
锳	qamd
𨱑	qamw
钜	qang
钺	qaxy
铽	qany
铹	qapl
铙	qatq
氏	qav
镬	qawc
𨱏	qawk
𫟹	qawy
𬬩	qay
邸	qayb
鸱	qayg
氐	qayi
镊	qbcc
铒	qbg
钌	qbh
卬	qbh
眢	qbhf
凶	qbk
锰	qblg
怨	qbnu
迎	qbpk
鸳	qbqg
锕	qbsk
色	qcb
𫔎	qcnk
铎	qcfh
勾	qci
钯	qcn
钗	qcyy
危	qdbb
𬱟	qdbm
郄	qdcb
钹	qdcy
肴	qdef
铕	qdeg
锛	qdfa
钴	qdg
锲	qdhd
𬭬	qdhv
郗	qdmb
希	qdmh
瓻	qdmy
铖	qdny
然	qdou
𫟼	qdpy
锜	qdsk
铸	qdtf
镣	qdui
镢	qduw
詹	qdwy
钛	qdyy
觭	qehk
锾	qefc
觟	qehf
锊	qefy
钥	qeg
觫	qehi
锄	qegl
觥	qehq
角	qehj
触	qehj
觿	qehk
觖	qehw
觚	qehy
钐	qet
觞	qehr
斛	qehf
觯	qehf
解	qehh
蟹	qehj
邂	qehp
𫓯	qffg
钍	qfg
针	qfh
镇	qfhw
𨱇	qfiy
𬭳	qfkk
镭	qflg
锗	qfjg
铐	qfgn
铑	qfxn
𫓧	qfwy
鳠	pawc
钘	qgah
铏	qgaj
鳓	pakl
鲽	pans
鲯	padw
鲰	pbcy
印	qgbh
钝	qgbn
鲬	pceh
鲹	pcde
铚	qgcf
鲐	pckg
鲃	pcn
鲅	pdcy
鲱	pjdd
鲔	pdeg
鲕	pdmj
䲠	pdwj
鱿	pdny
鳡	pdgn
鳜	pduw
镈	qgef
锖	qgeg
鳐	perm
铺	qgey
匍	qgey
鱼	ptng
鲑	pffg
鳍	pfxj
鲒	pfkg
𬶮	pfkk
鲼	pfam
鲮	pfwt
鳕	pkvg
鲭	pgeg
鲆	pguf
𬶠	pgli
𬶟	pgkj
鲾	pgkl
鲀	pgbn
鲠	pgjq
鲡	pgmy
鲏	phcy
钲	qghg
鲇	phkg
钙	qghn
鲈	phnt
鲿	pipc
盥	eilf
𬶐	pqiy
钚	qdhy
鳗	pjlc
鲁	pjf
鲤	pjfg
鲣	pjcf
鲥	pjfy
鳀	pjgh
𫚕	pjgh
鲳	pjjg
鳁	pjlg
鳎	pjng
鲲	pjxx
铻	qgkg
镉	qgkh
匐	qgkl
鳄	pkkn
鲴	pldg
鳂	plge
鳏	pliy
鳃	plny
鲢	plpy
鲉	pmg
鲗	pmjh
鲷	pmfk
鲖	pmgk
鳢	pmau
鳚	pnff
鲺	pntj
鱾	pnn
鳛	pnrg
鳞	poqh
铼	qgoy
鲩	ppfq
𩽾	ppvg
𬶍	ppxn
䲟	pqgb
𬶏	pqdb
𬶋	pqkg
鲍	pqnn
𩾃	pqkq
鳇	prgg
鲌	prg
鳈	priy
鲘	prgk
鳔	psfi
钱	qfxy
鲊	pthf
鲧	ptxi
鳤	ptpn
鳅	ptoy
鲦	ptsy
稣	pty
鿏	qgty
鲜	pudh
鳟	pusf
鳉	puqf
鳝	pudk
鳒	puvw
鲛	puqy
铗	qgud
鳑	pupo
鲫	pvcb
鲟	pvfy
鲪	pvtk
鲻	pvlg
鱽	pvt
𫚭	pvln
鲵	peqn
鲙	pwfc
鲋	pwfy
𬶭	pwfi
鳊	pyna
鳣	pylg
鳙	pyvh
鲸	pyiy
𩾌	pyvi
鲚	pyjh
鲂	pot
钰	qgyy
铍	qhcy
钼	qhg
钻	qhkg
𬬻	qhnt
外	qhy
钋	qhy
销	qieg
玺	qigy
𬭛	qihc
乐	qii
锁	qimy
铴	qinr
镗	qipf
迩	qipi
镋	qikq
铫	qqiy
钞	qitt
尔	qiu
铛	qivg
郇	qjbh
铿	qjcf
旬	qjd
象	qjeu
锂	qjfg
锝	qjsy
钽	qjgg
刈	qjh
钊	qjh
𬬹	qjhh
镘	qjlc
龟	qjnb
锡	qjqr
锞	qjsy
锟	qjxx
句	qkd
𫓶	qkeg
名	qkf
锃	qkgg
钏	qkh
钟	qkhh
铝	qkkg
锷	qkkn
劬	qklt
铞	qkmh
锅	qkmw
免	qkqb
鸲	qkqg
勉	qkql
逸	qkqp
够	qkqq
兔	qkqy
雊	qkwo
甸	qld
锢	qldg
铟	qldy
𬭶	qlfo
钿	qlg
镮	qlge
钾	qlh
锶	qlny
链	qlpy
镯	qlqj
锣	qlqy
奂	qmdu
镚	qmee
铀	qmg
铜	qmgk
铡	qmjh
铅	qmkg
铠	qmnn
钢	qmqy
负	qmu
夐	qmwt
钠	qmwy
钡	qmy
钒	qmyy
馍	qnad
馑	qnag
饶	qnaq
馓	qnat
饵	qnbg
饳	qnbm
饴	qnck
锯	qndg
馁	qnev
饽	qnfb
钮	qnfg
馌	qnfl
邬	qngb
乌	qngd
馕	qnge
𫗧	qngi
饨	qngn
饯	qnfy
镅	qnhg
馒	qnjc
刨	qnjh
馃	qnjs
馄	qnjx
蚀	qnjy
馈	qnkm
馉	qnme
饥	qnmn
钇	qnn
钆	qnn
饲	qnnk
锔	qnnk
饧	qnnr
馔	qnnw
馆	qnpn
馏	qnql
饱	qnqn
馋	qnqu
馅	qnqe
饮	qnqw
饭	qnrc
饩	qnrn
钖	qnrt
馇	qnsg
饫	qntd
饪	qntf
饰	qnth
饷	qntk
饹	qntk
饬	qntl
饿	qnty
铋	qntt
䥽	qnty
饼	qnua
馐	qnuf
饺	qnuq
包	qnv
馊	qnec
镠	qnwe
饸	qnwk
铌	qnxn
饻	qnye
𫗴	qnyg
鬯	qobx
镤	qogw
锬	qooy
𬭸	qoqh
炙	qou
镂	qovg
钬	qoy
𬭎	qpdc
镓	qpey
锭	qpgh
夤	qpgw
镔	qprw
铵	qpvg
镩	qpwh
镲	qpwi
镕	qpwk
铊	qpxn
匈	qqbk
铯	qqcn
钩	qqcy
镥	qojg
铄	qqiy
铭	qqkg
镵	qqky
钨	qqng
鑫	qqqf
金	qqqq
锪	qqrn
铩	qqsy
铆	qqtb
多	qqu
爻	qqu
钧	qqug
铮	qqvh
钦	qqwy
镏	qqyl
钓	qqyy
钣	qrcy
勿	qre
锧	qrfm
铂	qrg
锽	qrgg
𬬱	qrh
铢	qriy
刎	qrjh
锦	qrmh
兜	rqnq
忽	qrnu
锨	qrqw
铁	qrwy
匆	qryi
弑	qsaa
𬭊	qsfg
镖	qsfi
钵	qsgg
钉	qsh
刹	qsjh
镡	qsjh
杀	qsu
𬬸	qsyy
狨	eadt
獴	eape
猎	eajg
猫	ealg
獾	eako
𬬮	qtay
卯	qtbh
狲	ebiy
猛	eblg
犯	ebnn
犸	ecg
狁	ecqn
猱	ecns
狻	ecwt
猰	edhd
猢	edeg
锋	qtdh
獠	edui
猗	edsk
犹	edny
獗	eduw
狙	eegg
猺	eerm
锈	qten
铥	qtfc
猿	efke
钎	qtfh
犴	efh
猪	efjg
锆	qrkg
铤	qtfp
铣	qrqn
橥	efjs
锸	qtfe
猜	egeg
锤	qtgf
锺	qtgf
狂	egg
狉	edhg
𫛭	egqg
獭	egkm
逛	egpd
狭	egud
玃	ehhc
猇	eham
镍	qths
狸	ejfg
猩	ejtg
狮	ejgh
猖	ejjf
独	ejy
狷	ekeg
铬	qtkg
猬	eleg
猥	elge
狎	elh
猡	elqy
猾	emeg
猯	emdj
狈	emy
儿	qtn
狃	enfg
峱	enfm
夕	qtny
𫔍	qtol
逖	eopi
锹	qtoy
狄	eoy
狩	epfy
狞	epsh
狰	eqvh
獬	eqeh
狝	eqiy
狗	eqkg
狍	eqnn
锇	qtry
狐	ercy
猹	esjg
猁	etjh
獯	etgo
獐	eujh
狡	euqy
獍	eujq
卿	qtvb
狠	evey
犰	evn
猊	eeqn
狯	ewfc
猴	ewnd
猃	ewgi
㺄	ewgj
猞	ewfk
狳	ewsw
狴	exxf
猕	exqi
狒	exjh
乂	qty
狱	eydy
狼	eyve
猝	eywf
狺	eyg
𬸚	eydg
猄	eyiy
犷	eyy
匀	qud
锩	qudb
𬭼	quep
钭	qufh
锎	quga
镁	qugd
镧	qugi
锌	qufh
锏	qujg
镱	qujn
镜	qujq
锫	qukg
锐	qukq
镝	qumd
𬭯	qumt
钔	qun
镨	quoj
镑	qupo
锵	quqf
铰	quqy
𨱔	qusf
铲	qutt
镒	quwl
锑	quxt
镃	quxx
邹	qvbh
银	qvey
刍	qvf
键	qvfp
钕	qvg
皱	qvhc
锼	qehc
争	qvhj
铷	qvkg
𬬿	qvkg
锱	qvlg
镴	qvln
急	qvnu
锓	qvpc
鹐	qeqg
煞	qvto
雏	qvwo
𬭩	qwcn
锻	qwdc
铨	qwgg
铪	qwgk
镎	qwgr
镫	qogu
𬭤	qwnd
欠	qwu
锉	qwwf
铧	qwxf
𬬭	qwxn
铃	qwyc
飧	qwye
镌	qwoe
锥	qwog
钤	qwyn
𬭁	qxgu
镄	qxjm
镪	qxkj
锴	qxxr
镀	qyac
𬭚	qybg
镦	qybt
铳	qycq
锍	qyck
訇	qyd
铱	qyey
锿	qyey
久	qyi
勺	qyi
镶	qyke
铈	qymh
镐	qymk
钪	qymn
钫	qot
鹱	qync
袅	qyne
鸟	qyng
岛	qynm
凫	qynm
镳	qyno
枭	qyns
鸵	qynx
灸	qyou
孵	qytb
镞	qotd
卵	qyty
镰	qyuo
锒	qyve
鹠	qyvg
镛	qyvh
留	qyvl
贸	qyvm
遛	qyvp
铉	qyxy
拭	raag
皂	rab
揕	radn
撕	radr
撒	raet
扛	rag
摸	rajd
措	rajg
揠	rajv
描	ralg
拒	rang
拣	ranw
捞	rapl
抠	raqy
找	ray
挠	ratq
搭	rawk
搽	raws
拱	rawy
揶	rbbh
摄	rbcc
报	rbcy
拯	rbig
拙	rbmh
抒	rcnh
揉	rcns
掇	rccc
搡	rccs
㧐	rccy
掺	rcde
捅	rceh
择	rcfh
反	rci
抬	rckg
把	rcn
返	rcpi
挨	rctd
摊	rcwo
瓜	rcyi
搔	rcyj
瓞	rcyw
扼	rdbn
拔	rdcy
振	rdfe
拜	rdfh
捺	rdfi
皋	rdfj
挎	rdfn
翱	rdfn
拓	rdg
撼	rdgn
揳	rdhd
排	rjdd
掩	rdjn
颀	rdmy
扰	rdny
挞	rdpy
掎	rdsk
撩	rdui
撅	rduw
揍	rdwd
捧	rdwh
摏	rdwe
拢	rdxy
援	refc
捋	refy
拥	rehh
皭	relf
扔	ret
授	repc
摇	rerm
技	rfcy
挂	rffg
摴	rkfn
持	rffy
扞	rfh
盾	rfhd
遁	rfhp
擀	rfjf
拮	rfkg
撷	rfkm
擂	rklg
质	rfmi
抟	rfny
挝	rfpy
抚	rfqn
拷	rfgn
撵	rfwl
扶	rfwy
攉	rkwo
邱	rgbh
扽	rgbn
卮	rgbv
捯	rgcj
丘	rgd
掭	rgdi
搏	rgef
捕	rgey
皇	rgf
抔	rdhy
郈	rgkb
后	rgkd
攮	rfke
垕	rgkf
捂	rgkg
逅	rgkp
岳	rgmj
遑	rgpd
抹	rgsy
乒	rgtr
抨	rguf
挟	rgud
捷	rgvh
兵	rgwu
乓	rgyu
䴘	rhag
掳	rhal
虒	rham
摅	rhan
卸	rhbh
披	rhcy
看	rhf
年	rhfk
扯	rhg
攫	rhhc
拤	rhhy
掉	rhjh
牛	rhk
拈	rhkg
犇	rhrh
扑	rhy
爬	rhyc
爪	rhyi
㧟	rian
邾	ribh
捎	rieg
朱	rii
搅	ripq
撑	ripr
挑	rqiy
㿠	riqn
抄	ritt
泉	riu
挡	rivg
撮	rjbc
捏	rjfg
捍	rjfh
担	rjgg
提	rjgh
抻	rjhh
揭	rjqn
揽	rjtq
拽	rjxt
揖	rkbg
挹	rkcn
捐	rkeg
扣	rkg
捉	rly
操	rkks
捌	rklj
拐	rklt
损	rkmy
摁	rldn
摆	rlfc
擐	rlge
舞	rlgh
掴	rlgy
押	rlh
斶	rlqj
捆	rlsy
撂	rltk
摞	rlxi
缸	rmag
罐	rmao
投	rmcy
揣	rmdj
抽	rmg
罅	rmhh
制	rmhj
帛	rmhj
掣	rmhr
缶	rmk
撄	rmmv
皑	rmnn
缺	rmnw
摧	rmwo
搌	rnae
抿	rnan
气	rnb
掘	rnbm
撖	rnbt
氢	rnca
据	rndg
氪	rndq
氖	rner
扭	rnfg
氰	rnge
握	rngf
氩	rngg
氘	rnjj
氲	rnjl
氚	rnkj
氤	rnld
氙	rnmj
扎	rnn
癿	rnn
撰	rnnw
氮	rnoo
氨	rnpv
所	rnrh
扬	rnrt
氕	rntr
氡	rntu
拨	rnty
摒	rnua
氧	rnud
氯	rnvi
氛	rnwv
抉	rnwy
擢	rnwo
氟	rnxj
拟	rnyw
氦	rnyw
掞	rooy
搂	rovg
擞	rovt
迫	rpd
皖	rpfq
近	rpk
挥	rplh
摈	rprw
拧	rpsh
挓	rpta
按	rpvg
控	rpwa
撺	rpwh
擦	rpwi
挖	rpwn
探	rpws
扺	rqan
抵	rqay
抑	rqbh
魃	rqcc
魑	rqcc
魈	rqce
魁	rqcf
鬼	rqci
魅	rqci
魍	rqcn
魆	rqcy
魉	rqcw
魋	rqco
撸	rpjg
拘	rqkg
挽	rqkq
搀	rqku
换	rqmd
抱	rqnn
掬	rqoy
揿	rqqw
掏	rqrm
掐	rqeg
挣	rqvh
欣	rqwy
捣	rqym
的	rqyy
扳	rrcy
皈	rrcy
皞	rrdf
拍	rrg
折	rrh
搋	rrhm
抓	rrhy
晢	rrjf
蜇	rrju
哲	rrkf
踅	rrlu
逝	rrpk
魄	rrqc
掀	rrqw
皛	rrrf
白	rrrr
捭	rrtf
誓	rryf
皦	rrot
拆	rryy
摽	rsfi
打	rsh
揸	rsjg
托	rtan
拖	rtbn
括	rtdg
搬	rtec
郫	rtfb
鹎	rtfg
扦	rtfh
卑	rtfj
皓	rrkg
攒	rrqm
撬	rtfn
挺	rtfp
插	rtfe
捶	rtgf
手	rtgh
拃	rthf
攥	rthi
擤	rthj
播	rtol
皤	rtol
揪	rtoy
斤	rtth
拼	ruah
搠	rube
搓	ruda
掷	rudb
拦	rudg
抖	rufh
拌	rufh
拉	rug
撞	rujf
掸	rujf
掊	rukg
摘	rumd
擿	rump
撇	rumt
扪	run
搒	rupo
皎	ruqy
撙	rusf
搁	rutk
接	ruvg
搛	ruvo
挪	rvfb
挦	rvfy
扫	rvg
搜	rehc
招	rvkg
抛	rvlt
殷	rvnc
拶	rvqy
捃	rvtk
垫	rvyf
鸷	rvyg
絷	rvyi
蛰	rvyj
势	rvyl
贽	rvym
热	rvyo
挚	rvyr
执	rvyy
抢	rwbn
拊	rwfy
揆	rogd
拴	rwgg
捡	rwgi
揄	rwgj
拾	rwgk
失	rwi
迭	rwpi
扮	rwvt
掰	rwvr
挫	rwwf
抡	rwxn
扒	rwy
拎	rwyc
擒	rwyc
携	rwoe
推	rwog
捻	rwyn
掾	rxey
掼	rxfm
拇	rxgu
指	rxjg
拂	rxjh
拗	rxlt
搦	rxuu
批	rxxn
揩	rxxr
摭	ryao
摛	ryqc
撤	ryct
拄	rygg
掂	ryhk
抃	ryhy
斥	ryi
掠	ryiy
挤	ryjh
攘	ryke
擅	rylg
㧑	ryly
搞	rymk
抗	rymn
捩	rynd
掮	ryne
护	rynt
扩	ryt
邀	rotp
敫	roty
搪	ryvk
捽	rywf
掖	rywy
摔	ryxf
搐	ryxl
栻	saag
械	saah
栉	sabh
榧	sadd
椹	sadn
棋	sadw
柑	safg
杠	sag
框	sagg
欂	saif
栋	saiy
模	sajd
棤	sajg
槿	sakg
棫	sakg
横	samw
柜	sang
楪	sans
檬	sape
枢	saqy
柩	saqy
桡	satq
杙	say
椰	sbbh
椭	sbde
李	sbf
杼	scnh
橘	scnk
懋	scnn
楙	scns
桶	sceh
柽	scfg
树	scfy
杩	scg
杷	scn
梭	scwt
权	scy
杈	scyy
枯	sdg
柘	sdg
橱	sdgf
楔	sdhd
槭	sdhy
枥	sdlt
顶	sdmy
椅	sdsk
梆	sdtb
梼	sdtf
橑	sdui
橛	sduw
棒	sdwh
椿	sdwj
榛	sdwt
栊	sdxy
杕	sdy
杖	sdyy
桴	sebg
楹	secl
棚	seeg
杉	set
极	seyy
椓	seyy
鄄	sfbh
枝	sfcy
㭕	sfcy
桂	sffg
樗	skfn
杜	sfg
甄	sfgy
杆	sfh
植	sfhg
樾	sfhy
剽	sfij
飘	sfiq
票	sfiu
柰	sfiu
标	sfiy
瓢	sfiy
桔	sfkg
檑	sklg
楠	sfmf
椟	sfnd
梽	sfny
桲	sfpb
歅	sfqw
楮	sfjg
榰	sfxj
栲	sfgn
材	sftt
栳	sfxn
樯	sfuk
棱	sfwt
村	sfy
酣	sgaf
醛	sgag
枅	sgah
醋	sgaj
酏	sgbn
桎	sgcf
酸	sgct
本	sgd
酉	sgd
醐	sgde
酤	sgdg
醢	sgdl
酞	sgdy
酹	sgef
榑	sgef
酵	sgfb
酝	sgfc
酐	sgfh
酎	sgfy
枉	sgg
酽	sggd
酺	sggy
酾	sggy
丁	sgh
醵	sghe
西	sghg
杯	sdhy
醒	sgjg
桓	sgjg
醍	sgjh
橞	sgjn
梗	sgjq
醌	sgjx
梧	sgkg
酲	sgkg
楝	sgli
槽	sgmj
酮	sgmk
醴	sgmu
柄	sgmw
醪	sgne
醑	sgne
朽	sgnn
配	sgnn
酦	sgny
桠	sgog
醚	sgop
梾	sgoy
醭	sgow
𬪩	sgpe
酡	sgpx
酗	sgqb
酩	sgqk
杌	sgqn
酌	sgqy
酊	sgsh
栈	sfxy
酢	sgtf
酪	sgtk
酷	sgrk
醺	sgto
酰	sgtq
酶	sgtu
酥	sgty
枰	sguf
醅	sguk
𬂩	sgud
醮	sgwo
酴	sgww
酚	sgwv
酯	sgxj
醇	sgyb
醨	sgyc
酿	sgye
醉	sgyf
酬	sgyh
醯	sgyl
醾	sgyo
相	shg
椒	shic
棹	shjh
桢	shmy
栌	shnt
想	shnu
朴	shy
梢	sieg
桫	siit
樘	sipf
𣗋	sipq
桃	sqiy
桄	siqn
杪	sitt
档	sivg
榉	siwh
杳	sjf
查	sjgf
覃	sjj
榅	sjlg
榻	sjng
棵	sjsy
槛	sjtl
榄	sjtq
棍	sjxx
楫	skbg
可	skd
杏	skf
桯	skgg
枵	skgn
梠	skkg
𫫇	kgon
柷	skqn
哥	sksk
歌	sksw
枳	skwy
柙	slh
枷	slkg
朸	slt
楒	slny
梿	slpy
椤	slqy
楞	slot
椆	smfk
柚	smg
桐	smgk
栅	smmg
樱	smmv
机	smn
桤	smnn
枧	smqn
枫	smqy
㭎	smqy
贾	smu
梣	smwn
枘	smwy
橄	snbt
椐	sndg
杻	snfg
栩	sng
楣	snhg
榍	snie
樨	snih
札	snn
杞	snn
杨	snrt
棪	sooy
杰	sou
粟	sou
楼	sovg
迺	spd
棕	spfi
楦	spgg
棺	sphn
椀	spqb
枕	spqn
槟	sprw
柠	spsh
桉	spvg
榨	spwf
檫	spwi
榕	spwk
榷	spwo
柁	spxn
柢	sqay
构	sqcy
桅	sqdb
檐	sqdy
槲	sqef
桷	sqeh
檞	sqeh
橹	spjg
栎	sqiy
橡	sqje
栒	sqjg
枸	sqkg
枹	sqnn
樊	sqqd
攀	sqqr
柳	sqtb
榴	sqyl
杓	sqyy
板	srcy
槔	srdf
楯	srfh
𬃊	srfm
柏	srg
栀	srgb
析	srh
株	sriy
棉	srmh
槐	srqc
櫆	srqf
皙	srrf
椑	srtf
檄	srot
柝	sryy
郴	ssbh
彬	sset
禁	ssfi
栖	ssg
槱	ssgo
楂	ssjg
柯	sskg
榃	sslg
梵	ssmy
槚	ssmy
楚	ssnh
焚	ssou
梦	ssqu
木	ssss
森	sssu
栗	ssu
婪	ssvf
棽	sswn
棼	sswv
林	ssy
麓	ssyx
枨	stay
栝	stdg
桥	stdj
杵	stfh
桁	stfh
杄	stfh
梏	srkg
橇	stfn
梃	stfp
棰	stgf
柞	sthf
梴	sthp
格	stkg
榭	stmf
栴	stmy
楸	stoy
㰀	stqi
覆	sttt
柊	stuy
梅	stxu
枚	sty
栟	suah
槎	suda
棬	sudb
样	sudh
栏	sudg
柈	sufh
梓	sufh
橦	sujf
樟	sujh
棓	sukg
榈	sukk
棁	sukq
椪	suog
榜	supo
校	suqy
樽	susf
榇	susy
梯	suxt
概	svcq
根	svey
要	svf
楗	svfp
桕	seg
棣	sviy
柖	svkg
棂	svoy
枪	swbn
松	swcy
椴	swdc
桧	swfc
栓	swgg
检	swgi
榆	swgj
枍	swgn
楩	swgq
橙	sogu
槌	swnp
梌	swsw
枞	swwy
桦	swxf
朳	swy
檎	swyc
柃	swyc
槜	swoe
榫	swof
椎	swog
樵	swoo
椽	sxey
橼	sxxe
枇	sxxn
楷	sxxr
椁	sybg
梳	syck
桩	syfg
槠	syfj
柱	sygg
术	syi
椋	syiy
榱	syke
檀	sylg
檩	syli
柿	symh
槁	symk
杭	symn
枋	sot
栐	syni
杧	synn
核	synw
述	sypi
椸	sotb
榔	syvb
桹	syve
筇	tabj
簸	tadc
篚	tajd
箬	tadk
箕	tadw
簕	takl
筐	tagf
箧	tagw
逄	tahp
升	tak
笸	takf
𬕂	tamu
簧	tamw
筑	tamy
秬	tang
簪	taqj
彻	tavt
筮	taww
长	tayi
季	tbf
迤	tbpv
径	tcag
笆	tcb
䅟	tcde
笃	tcf
笞	tckf
么	tcu
私	tcy
甜	tdaf
矩	tdan
舌	tdd
舔	tdgi
箴	tdgy
短	tdgu
逢	tdhp
夭	tdi
籍	tdij
徘	tjdd
刮	tdjh
乔	tdjj
知	tdkg
智	tdkj
岙	tdmj
稽	tdnj
嵇	tdnm
乱	tdnn
适	tdpd
舐	tdqa
鸹	tdqg
徛	tdsk
筹	tdtf
矫	tdtj
憩	tdtn
矮	tdtv
敌	tdty
矢	tdu
辞	tduf
簝	tdui
矰	tduj
矬	tdwf
雉	tdwo
笼	tdxy
矧	tdxh
艨	teae
秀	ter
稃	tebg
艋	tebl
舥	tecn
租	tegg
徂	tegg
艚	tegj
舻	tehn
舟	tei
艄	teie
甪	tehk
舯	tekh
筋	telr
盘	telf
般	temc
磐	temd
舳	temg
舢	temh
船	temk
舰	temq
槃	tems
艉	tenn
透	tepe
舵	tepx
鸼	teqg
舶	terg
艎	terg
徭	term
舾	tesg
舸	tesk
舴	tetf
艇	tetp
艟	teuf
艏	teuh
艘	teec
稻	teeg
舠	tevt
舱	tewb
舲	teyc
艅	teww
舭	texx
航	teym
舫	teot
舣	teyq
笈	teyu
舷	teyx
丢	tfcu
壬	tfd
竺	tff
筀	tfff
街	tffh
衎	tffh
等	tffu
待	tffy
秆	tfh
鸻	tfhg
稙	tfhg
行	tfhh
衠	tfhh
稹	tfhw
徒	tfhy
午	tfj
竿	tfj
篝	tfjf
千	tfk
郜	rkbh
靠	rkjd
告	rkf
秸	tfkg
鹄	rkqg
造	rkpd
德	tfln
毪	tfnh
氇	tfnj
氆	tfnj
毡	tfnk
毳	tfnn
毯	tfno
毽	tfnp
毛	tfnv
廷	tfpd
迁	tfpk
迕	tfpk
颋	tfpm
先	rqb
酂	rqrb
赞	rqrm
选	rqpv
筠	tfqu
箸	tfjf
穑	tfuk
乖	tfux
歃	tfew
稑	tfwf
垂	tgaf
笄	tgaj
生	tgd
箐	tgef
簠	tgel
竽	tsj
眚	tghf
征	tghg
惩	tghn
重	tgjf
穗	tgjn
筻	tgjq
衙	tgkh
籁	tgkm
簌	tgkw
甥	tgll
熏	tglo
策	tgmi
箦	tgmu
徕	tgoy
笺	tfxy
秣	tgsy
甡	tgtg
秤	tguf
秉	tgvi
算	thaj
彼	thcy
自	thd
篡	thdc
纂	thdi
臭	thdu
乍	thfd
怎	thfn
迮	thfp
版	thgc
牍	thgd
牌	thgf
片	thgn
牒	thgs
牖	thgy
衢	thhh
徙	thhy
处	thi
昝	thjf
咎	thkf
齉	thle
鼾	thlf
齇	thlg
鼻	thlj
劓	thlj
齁	rhlk
鼽	thlv
息	thnu
延	thpd
臬	thsu
筲	tief
稍	tieg
衍	tifh
愆	tifn
簿	tigf
徜	timk
箔	tirf
秒	titt
筜	tivg
香	tjf
馞	tjfb
得	tjsy
笪	tjgf
筛	tjgh
利	tjh
馧	tjjl
馝	tjnt
犁	tjrh
梨	tjsu
稞	tjsy
篮	tjtl
馥	tjtt
复	tjtu
各	tkf
和	tkg
程	tkgg
种	tkhh
篑	tkhm
筥	tkkf
稆	tkkg
鄅	tkmb
筼	tkmu
禹	tkmy
积	tkwy
雒	tkwo
务	tlr
血	tld
篾	tldy
备	tlf
盉	tlf
睾	tlff
衃	tldh
箅	tlgj
笳	tlkf
徊	tlkg
衄	tlnf
惫	tlnu
粤	tlon
笾	tlpu
囟	tlqi
箩	tlqu
囱	tlqi
衅	tluf
稷	tlwt
秃	tmb
役	tmcy
射	tmdf
躺	tmdk
颓	tmdm
躯	tmdq
躲	tmds
身	tmdt
躬	tmdx
秧	tmdy
笛	tmf
稠	tmfk
筒	tmgk
微	tmgt
徽	tmgt
徵	tmgt
币	tmhk
向	tmkd
奥	tmod
笕	tmqb
秽	tmqy
乞	tnb
笥	tngk
筷	tnnw
迄	tnpv
秘	tntt
释	toch
穙	togw
鄱	tolb
番	tolf
𬸪	tolg
翻	toln
釉	tomg
簖	tonr
悉	tonu
愁	tonu
鹙	toqg
篓	tovf
秋	toy
稼	tpey
秾	tpey
筦	tpfq
乏	tpi
管	tphn
箢	tpqb
箜	tpwa
稀	tqdh
衡	tqlh
衔	tqfh
篯	tqfy
称	tqiy
徇	tqjg
笱	tqkf
移	tqqy
篼	trqq
笏	tqrr
黎	tqti
黧	tqto
筝	tqvh
稳	tqvn
箍	trah
筢	trcb
箨	trch
牻	rhdy
牯	rhdg
犄	rhdk
犊	rhfd
特	rhff
牡	rhfg
循	trfh
篁	trgf
徨	trgg
牾	rhgk
御	trhb
篪	trhm
犋	rhhw
笊	trhy
穆	trie
筘	trkf
鹅	trxg
我	trxy
籀	trql
物	rhqr
牺	rhsg
稗	trtf
牲	rhtg
牿	rhrk
牦	rhtn
牧	rhty
犍	rhvp
秩	trwy
牝	rhxn
犏	rhya
犒	rhyk
牤	rhyn
牥	rhot
徼	trot
笨	tsgf
箱	tshf
簟	tsjj
篥	tssu
箖	tssu
条	tsu
秫	tsyy
篷	ttdp
笑	ttdu
筶	trkf
笔	ttfn
簉	trkp
筅	trqb
笙	ttgf
竹	ttgh
笮	tthf
簰	tthf
筵	tthp
篦	ttlx
秭	ttnt
笫	ttnt
簃	ttqq
彳	ttth
禾	tttt
徉	tudh
箭	tuej
穟	tuep
笠	tuf
科	tufh
乎	tufk
简	tujf
箪	tujf
穜	tujf
螽	tujj
税	tukq
冬	tuu
剩	tuxj
乘	tuxv
笯	tvcu
簋	tvel
很	tvey
委	tvf
律	tvfh
箫	tvij
箓	tviu
笤	tvkf
逶	tvpd
魏	tvrc
笋	tvtr
筏	twau
穄	twfi
符	twfu
籥	twga
筌	twgf
签	twgi
劄	twgj
答	twgk
筱	twht
黏	twik
黍	twiu
篌	twnd
徐	twsw
稌	twsw
稚	twog
稔	twyn
胤	txen
篆	txeu
鳘	txgp
繁	txgi
毓	txgk
敏	txgt
每	txgu
第	txht
系	txiu
筚	txxf
秕	txxn
篱	tybc
往	tygg
入	tyi
汆	tyiu
穰	tyke
稿	tymk
篙	tymk
彷	tot
篇	tyna
簏	tynx
籴	tyou
簇	totd
稂	tyve
筤	tyve
衒	wyxh
凘	uadr
疳	uafd
冮	uag
疟	uagd
瓶	uagy
冻	uaiy
并	uaj
瘼	uajd
阈	uakg
癀	uamw
迸	uapk
痨	uapl
瘩	uawk
闻	ubd
疗	ubk
疖	ubk
瘾	ubqn
朔	ubte
塑	ubtf
癃	ubtg
逆	ubtp
槊	ubts
痉	ucad
闯	ucd
瘆	ucde
痛	uceh
衮	uceu
冯	ucg
冶	uckg
兖	ucqb
疤	ucv
竣	ucwt
瘫	ucwo
瘙	ucyj
差	udaf
卷	udbb
郑	udbh
羟	udca
闳	udci
羓	udcn
羧	udct
竑	udcy
闫	udd
羱	uddi
豢	udeu
减	udgy
着	udhf
眷	udhf
瘛	udhn
头	udi
羊	udj
痱	ujdd
判	udjh
阉	udjn
羯	udjn
疬	udle
羖	udmc
羰	udmo
羌	udqb
羞	udnf
翔	udng
疠	udnv
疣	udny
送	udpi
闼	udpi
鲞	udpf
鲝	udpf
羝	udqy
叛	udrc
拳	udrj
桊	udsu
关	udu
鄯	udub
善	uduk
券	udvb
羚	udwc
凑	udwd
状	udy
誊	udyf
养	udwj
疽	uegd
前	uejj
翦	uejn
煎	uejo
剪	uejv
痈	uehk
毅	uemc
阌	uepc
遂	uepi
瘃	ueyi
阖	ufcl
兰	udf
闺	uffd
痔	uffi
壮	ufg
癫	ufhm
阗	ufhw
斗	ufk
半	ufk
癗	ukld
闱	ufnh
痣	ufni
闭	ufte
阇	ufjd
凌	ufwt
装	ufye
痓	ugcf
闰	ugd
闩	ugd
美	ugdu
靖	ugeg
症	ughd
痞	udhk
痦	ugkd
辣	udgi
竦	ugki
瘌	ugkj
癞	ugkm
痘	ugku
盖	uglf
阑	ugli
病	ugmw
恙	ugnu
羹	ugod
羔	ugou
冽	ugqj
羑	ugqy
羲	ugty
瘗	uguf
羡	uguw
姜	ugvf
凄	ugvv
冱	ugxg
痍	ugxw
癍	ugyg
羕	ugyi
疲	uhci
阒	uhdi
癯	uhho
丫	uhk
站	uhkg
夔	utht
疵	uhxv
痧	uiit
阔	uitd
瘠	uiwe
冰	uiy
鄣	ujbh
间	ujd
彰	ujet
音	ujf
郸	ujfb
冁	ujfe
童	ujff
单	ujfj
𦒍	ujfn
疸	ujgd
闽	uji
章	ujj
阊	ujjd
瘟	ujld
阘	ujnd
意	ujnu
竟	ujqb
竭	ujqn
韵	ujqu
歆	ujqw
赣	ujtm
戆	ujtn
韶	ujvk
部	ukbh
问	ukd
瓿	ukgy
冲	ukhh
剖	ukjh
闾	ukkd
癌	ukkm
总	uknu
兑	ukqb
竞	ukqb
况	ukqn
痼	uldd
痹	ulgj
兽	ulgk
鄫	uljb
曾	uljf
甑	uljy
䎖	uljn
闸	ulk
痂	ulkd
瘸	ulkw
阃	ulsi
瘰	ulxi
疫	umci
端	umdj
凋	umfk
弊	umia
鳖	umip
瞥	umih
蹩	umih
憋	umin
敝	umit
疝	umk
瘿	ummv
闿	umnv
疯	umqi
飒	umqy
商	umwk
癜	unac
阚	unbt
翊	ung
瘕	unhc
闷	uni
癖	unkf
疡	unre
瘳	unwe
决	unwy
普	uogj
疢	ooi
痰	uooi
瘘	uovd
帝	upmh
啻	upmk
遆	uphp
旁	upob
阍	uqaj
郊	uqbh
奖	uqdu
将	uqfy
癣	upud
浆	uqiu
阄	uqjn
竘	uqkg
痪	uqmd
疱	uqnv
䴔	uqqg
酱	uqsg
桨	uqsu
效	uqty
交	uqu
阎	uqed
净	uqvh
竫	uqvh
咨	uqwk
盗	uqwl
资	uqwm
瓷	uqwy
恣	uqwn
粢	uqwo
姿	uqwv
次	uqwy
疚	uqyi
瘤	uqyl
瓣	udrf
𬮱	usfd
瘭	usfi
奠	usgd
猷	usgd
尊	usgf
酋	usgf
遵	usgp
遒	usgp
闲	usi
疔	usk
疴	uskd
鹇	usqg
新	usrh
凓	ussy
亲	usu
凇	uswc
疾	utdi
痴	utdk
产	ute
瘢	utec
颜	utem
彦	uter
冼	urqn
首	uthf
痄	uthf
馘	uthg
道	uthp
𫔶	uths
瘪	uthx
痢	utjk
阁	utkd
疙	utnv
疼	utui
痿	utvd
阙	uubw
瘥	uuda
痒	uudk
阐	uujf
瘅	uujf
瘴	uujk
癔	uujn
阅	uukq
痫	uusi
立	uuuu
痕	uvei
妾	uvf
妆	uvg
瘦	uehc
鹣	uvog
兼	uvou
歉	uvow
阋	ueqv
瘐	uewi
阀	uwai
疮	uwbv
疹	uwee
瘵	uwfi
痊	uwgd
阕	uogd
闪	uwi
疥	uwjk
益	uwlf
鹢	iwlg
蠲	uwlj
瘊	uwnd
痤	uwwf
疭	uwwi
冷	uwyc
准	uwog
邶	uxbh
背	uxef
鹈	uxhg
剃	uxhj
递	uxhp
弟	uxht
冀	uxlw
北	uxn
凝	uxth
辫	udxf
孳	uxxb
鹚	uxxg
慈	uxxn
兹	uxxu
訚	uyd
疰	uygd
辛	ufj
六	uygy
门	uyhn
闵	uyi
凉	uyiy
凛	uyli
闹	uymh
闶	uymv
阂	uynw
辨	udjf
辩	udyf
阆	uyve
瘁	uywf
阏	uowu
瘀	uowu
痃	uyxi
婼	vadk
娀	vadt
媒	vafs
姬	vahh
舁	eaj
嫫	vajd
毁	eamc
媖	vamd
妪	vaqy
嫕	vatn
娆	vatq
嬿	vauo
娵	vbcy
好	vbg
媸	vbhj
她	vbn
婀	vbsk
暨	vcag
𫰛	vcag
𬶨	vcap
既	vcaq
孥	vcbf
堲	vcbf
即	vcbh
妤	vcnh
驽	vccf
砮	vcdf
㛚	vceh
妈	vcg
始	vckg
努	vclr
帑	vcmh
胬	vcmw
怒	vcnu
弩	vcxb
奴	vcy
妭	vdcy
娠	vdfe
姱	vdfn
姑	vdg
媆	vdmd
嫄	vdri
婍	vdsk
嫽	vdui
媛	vefc
垦	veff
姐	vegg
艮	vei
奶	vet
恳	venu
嫒	vepc
退	vepi
媱	verm
彟	vfac
那	vfbh
𬩽	vfbh
妓	vfcy
妘	vfcy
嬬	vkdj
娃	vffg
奸	vfh
聿	vfhk
建	vfhp
妹	vfiy
媾	vfjf
姞	vfkg
嬉	vfkk
婻	vfmf
妩	vfqn
妧	vfqn
孀	vksh
姥	vfxn
寻	vfu
婞	vfuf
嫱	vfuk
妍	vgah
婧	vgeg
婊	vgey
嫣	vgho
姮	vgjg
嫩	vgkt
婳	vglb
娅	vgog
婕	vgvh
姨	vgxw
嫭	vhah
虓	vham
叟	ehcu
婌	vhic
隶	vii
鹔	vijg
剥	vijh
肃	vijk
嫦	viph
逮	vipi
逯	vipi
姚	vqiy
妙	vitt
录	viu
旭	vjd
旮	vjf
娌	vjfg
妲	vjgg
媞	vjgh
娼	vjjg
嫚	vjlc
媪	vjlg
剿	vjsj
巢	vjsu
婫	vjxx
邵	vkbh
邕	vkcb
娟	vkeg
召	vkf
如	vkg
娱	vkgd
劭	vklt
娲	vkmw
恕	vknu
迢	vkpd
絮	vkxi
姻	vldy
甾	vlf
嬛	vlge
舅	ellr
邋	vlqp
嫘	vlxi
婤	vmfk
妯	vmg
娉	vmgn
姗	vmmg
妞	vnfg
婿	vnhe
媚	vnhg
妃	vnn
刀	vnt
娓	vntn
鼫	enud
鼷	enud
鼱	enue
鼯	enuk
鼩	enuk
鼬	enum
鼠	enun
鼢	enuv
鼹	enuv
嫪	vnwe
嬥	vnwo
妮	vnxn
姒	vnyw
灵	vou
嫁	vpey
婶	vpjh
帚	vpmh
婠	vphn
婉	vpqb
嫔	vprw
姹	vpta
巡	vpv
婚	vqaj
姽	vqdb
娩	vqkq
舄	eqou
鸠	vqyg
妁	vqyy
媓	vrgg
姤	vrgk
姝	vriy
婢	vrtf
嫖	vsfi
杂	vsu
娇	vtdj
妖	vtdy
尹	vte
妊	vtfg
姓	vtgg
臼	ethg
媳	vthn
郡	vtkb
君	vtkf
群	vtkd
𫖳	vtkm
媲	vtlx
九	vtn
姊	vtnt
娥	vtry
姘	vuah
婘	vudb
媄	vugd
婵	vujf
嫜	vujh
嫡	vumd
媂	vuph
姣	vuqy
娴	vusy
嫉	vutd
馗	vuth
嫌	vuvo
娣	vuxt
娜	vvfb
妇	vvg
嫂	vehc
女	vvvv
姶	vwgk
㛹	vwgq
臾	ewi
孅	vwwg
姈	vwyc
妗	vwyn
姆	vxgu
妣	vxxn
訄	vyd
丸	vyi
刃	vyi
嬗	vylg
妫	vyly
妨	vot
妒	vynt
忍	vynu
婷	vyps
嬷	vysc
娘	vyve
偌	wadk
偡	wadn
仝	waf
垡	waff
垈	waff
伢	waht
借	wajg
偃	wajv
黛	walo
岱	wamj
贷	wamu
僭	waqj
儆	waqt
伛	waqy
牮	warh
伐	way
侥	watq
供	wawy
代	way
袋	waye
戗	wbay
仓	wbb
倻	wbbh
仔	wbg
佴	wbg
创	wbjh
他	wbn
鸧	wbqg
颂	wcdm
俑	wceh
瓮	wcgy
佁	wckg
翁	wcnf
鹟	wcng
侔	wcrh
俟	wctd
公	wcu
俊	wcwt
傩	wcwo
仅	wcy
佐	wdag
侑	wdeg
倴	wdfa
傉	wdff
侉	wdfn
估	wdg
仨	wdg
偰	wdhd
俳	wjdd
佰	wdjg
俺	wdjn
佑	wdkg
段	wdmc
偭	wdmd
优	wdny
倚	wdsk
俦	wdtf
做	wdty
僚	wdui
俸	wdwh
傣	wdwi
伏	wdy
仗	wdyy
俘	webg
佣	wehh
偁	wemf
仍	wet
傒	wexd
伋	weyy
偾	wfam
郐	wfcb
刽	wfcj
会	wfcu
伎	wfcy
儒	wkdj
佳	wffg
侍	wffy
仁	wfg
仕	wfg
什	wfh
值	wfhg
畲	wfil
祭	wfiu
佘	wfiu
俅	wfiy
舒	wfkh
舍	wfkf
佶	wfkg
僖	wfkk
舆	elgw
爨	wfmo
璺	wfmy
伟	wfnh
传	wfny
佬	wfxn
佞	wfvg
付	wfy
侄	wgcf
倒	wgcj
戣	ogda
癸	ogdu
鄃	wgeb
傅	wgef
倩	wgeg
俞	wgej
愈	wgen
毹	wgen
逾	wgep
觎	wgeq
俵	wgey
全	wgf
伍	wgg
佥	wgif
伾	wdhg
剑	wgij
敛	wgit
便	wgjq
龠	wgka
弇	wgka
命	wgkb
郃	wgkb
合	wgkf
鸽	wgkg
盒	wgkl
凳	ogkm
颌	wgkm
翕	wgkn
使	wgkq
拿	wgkr
龢	wgkt
登	ogku
歙	wgkw
龛	wgkx
僵	wglg
俩	wgmw
债	wgmy
俪	wgmy
兮	wgnb
侴	wgnj
佤	wgny
俨	wgod
俫	wgoy
例	wgqj
傲	wgqt
侠	wgud
傃	wgxi
企	whf
俶	whic
个	whj
倬	whjh
侦	whmy
候	whnd
倏	whtd
修	whte
脩	whte
悠	whtn
翛	whtn
攸	whty
俱	whwy
仆	why
俏	wieg
倘	wimk
偿	wipc
傥	wipq
佻	wqiy
俚	wjfg
但	wjgg
伸	wjhh
介	wjj
倡	wjjg
偶	wjmy
偈	wjqn
倮	wjsy
俣	wkgd
仲	wkhh
促	wly
侣	wkkg
侃	wkkn
堡	wksf
煲	wkso
保	wksy
佃	wlg
偎	wlge
儇	wlge
伽	wlkg
儡	wlll
仂	wlt
偲	wlny
倜	wmfk
佩	wmgh
侗	wmgk
俜	wmgn
仙	wmh
侧	wmjh
仉	wmn
伣	wmqn
催	wmwo
倔	wnbm
倨	wndg
偓	wngf
伺	wngk
假	wnhc
僻	wnkf
亿	wnn
阜	wnnf
追	wnnp
僎	wnnw
侯	wntd
佖	wntt
僇	wnwe
伲	wnxn
伈	wny
似	wnyw
倓	wooy
偻	wovg
伙	woy
侬	wpey
倧	wpfi
伫	wpgg
倌	wphn
傧	wprw
侘	wpta
倥	wpwa
傕	wpwo
佗	wpxn
低	wqay
仰	wqbh
爷	wqbj
爸	wqcb
俙	wqdh
儋	wqdy
釜	wqfu
您	wqin
你	wqiy
像	wqje
佝	wqkg
儳	wqky
爹	wqqq
侈	wqqy
斧	wqrj
偬	wqrn
父	wqu
㑇	wqvg
伯	wrg
件	wrhh
侏	wriy
傀	wrqc
俾	wrtf
佚	wrwy
体	wsgg
仃	wsh
何	wskg
僳	wsoy
鸺	wsqg
傈	wssy
休	wsy
伥	wtay
叙	wswc
仫	wtcy
佸	wtdg
侨	wtdj
任	wtfg
仟	wtfh
仵	wtfh
凭	wtfm
赁	wtfm
恁	wtfn
侹	wtfp
侁	wrqn
倕	wtgf
作	wthf
俐	wtjh
畬	wswl
伤	wtlt
傻	wtlt
仡	wtnn
悆	wswn
途	wswp
俄	wtry
余	wswu
斜	wswf
㙦	wswf
佟	wtuy
倭	wtvg
侮	wtxu
八	wty
倦	wudb
佯	wudh
伴	wufh
位	wug
伞	wufj
僮	wujf
𫢸	wujh
倍	wukg
僧	wulj
们	wun
傍	wupo
佽	wuqw
佼	wuqy
僔	wusf
分	wvb
邠	wvbh
颁	wvdm
坌	wvff
健	wvfp
盆	wvlf
岔	wvmj
贫	wvmu
仇	wvn
忿	wvnu
侵	wvpc
倪	weqn
伊	wvtt
攽	wvty
仞	wvyy
耸	wwbf
伧	wwbn
佾	wweg
俎	wweg
侩	wwfc
坐	wwff
傺	wwfi
丛	wwgf
佺	wwgg
俭	wwgi
偷	wwgj
价	wwjh
郤	wwkb
谷	wwkf
鹆	wwkg
欲	wwkw
谼	wwkw
怂	wwnu
份	wwvt
俗	wwwk
众	wwwu
人	wwww
伦	wwxn
从	wwy
伶	wwyc
僬	wwoo
仑	wxb
倾	wxdm
华	wxfj
佛	wxjh
货	wxmu
化	wxn
仳	wxxn
偕	wxxr
禽	wybc
邻	wycb
鸰	wycg
领	wycm
瓴	wycy
翎	wycn
令	wycu
隽	woer
依	wyey
储	wyfj
隼	wofj
信	wyg
隹	wog
住	wygg
僦	wyin
倞	wyiy
侪	wyjh
儴	wyke
售	wokf
伪	wyly
伉	wymn
仿	wot
偏	wyna
今	wynb
衾	wyne
含	wynk
盦	wynl
贪	wynm
颔	wynm
念	wynn
儦	wyno
鹪	woog
劁	wooj
焦	woou
㑊	wyoy
停	wyps
仪	wyqy
集	wosu
侂	wyta
食	wyve
俍	wyve
俯	wywf
犨	wowh
伭	wyxy
雠	woyo
绒	xadt
绀	xafg
缂	xakh
红	xag
绁	xann
练	xanw
𫸩	xaqy
绕	xatq
弭	xbg
弢	xmcy
绌	xbmh
弛	xbn
经	xcag
纾	xcnh
缀	xccc
绎	xcfh
绐	xckg
弘	xcy
绂	xdcy
纮	xdcy
毋	xde
缛	xdff
绔	xdfn
缄	xdgy
绯	xjdd
弼	xdjx
缅	xdmd
顷	xdmy
绮	xdsk
绑	xdtb
缭	xdui
绷	xeeg
弸	xeeg
缓	xefc
组	xegg
蠡	xejj
绶	xepc
彖	xeu
绥	xevg
级	xeyy
纭	xfcy
𦈡	xkdj
疆	xfgg
缜	xfhw
毌	xfk
结	xfkg
缬	xfkm
贯	xfmu
续	xfnd
纬	xfnh
鸨	xfqg
绪	xfjg
绫	xfwt
纣	xfy
纯	xgbn
绖	xgcf
缚	xgef
𬘬	xgeg
纡	xsh
绠	xgjq
缰	xglg
绩	xgmy
彝	xgoa
缙	xgoj
线	xfxy
母	xgui
彘	xgxx
引	xhh
缈	xhit
绰	xhjh
颍	xidm
绡	xieg
绱	ximk
纱	xitt
旨	xjf
缇	xjgh
绅	xjhh
弗	xjk
缦	xjlc
缊	xjlg
费	xjmu
艴	xjqc
缆	xjtq
绲	xjxx
缉	xkbg
绢	xkeg
𬘓	xkh
缱	xkhp
犟	xkjh
绳	xkjn
强	xkjy
缲	xkks
织	xkwy
𬘡	xldy
𬙊	xlff
细	xlg
缳	xlge
幼	xlt
缌	xlny
缧	xlxi
辔	xlxk
绸	xmfk
䌹	xmkg
缨	xmmv
纲	xmqy
纳	xmwy
缗	xnaj
纽	xnfg
弓	xngn
纠	xnhh
幻	xnn
纪	xnn
幺	xnny
缪	xnwe
颎	xodm
继	xonn
缕	xovg
鬻	xoxh
粥	xoxn
综	xpfi
𬘫	xpfq
纻	xpgg
绽	xpgh
𬙂	xpgw
绾	xphn
𬘘	xpqn
缤	xprw
缩	xpwj
纸	xqan
绝	xqcn
𫄨	xqdh
弥	xqiy
绚	xqjg
绹	xqrm
绉	xqvg
约	xqyy
弧	xrcy
缐	xriy
绵	xrmh
缴	xrot
缥	xsfi
缃	xshg
𬘭	xssy
绛	xtah
张	xtay
疑	xtdh
肄	xtdh
颖	xtdm
缝	xtdp
乡	xte
绣	xtet
纴	xtfg
纤	xtfh
绗	xtfh
缵	xrqm
𬘩	xtfp
𫄸	xtgo
绺	xthk
𫄧	xthp
络	xtkg
匕	xtn
纥	xtnn
绦	xtsy
终	xtuy
飨	xtwe
绻	xudb
缮	xudk
绊	xufh
弹	xujf
𫄷	xujn
缯	xulj
缔	xuph
绞	xuqy
缣	xuvo
缢	xuwl
绨	xuxt
弱	xuxu
绿	xviy
缫	xvjs
绍	xvkg
弨	xvkg
缁	xvlg
纫	xvyy
纨	xvyy
缎	xwdc
绘	xwfc
给	xwgk
缑	xwnd
缒	xwnp
纷	xwvt
绤	xwwk
纵	xwwy
纶	xwxn
维	xwog
畿	xxal
缘	xxey
坒	xxff
毕	xxfj
丝	xxgf
鸶	xxgg
毙	xxgx
纼	xxhh
绋	xxjh
幽	mxxi
比	xxn
毖	xxnt
皆	xxrf
纰	xxxn
缡	xybc
𬘯	xybg
统	xycq
弶	xyiy
𫟅	xyiy
缠	xyjf
缞	xyke
𬙋	xyke
缟	xymk
纺	xot
编	xyna
纩	xyt
弦	xyxy
纹	xyy
试	yaag
诫	yaah
度	yaci
诺	yadk
谌	yadn
谋	yafs
讧	yag
诓	yagg
讶	yaht
谟	yajd
谨	yakg
廑	yakg
席	yamh
讵	yang
谍	yans
庹	yany
鹧	yaog
庶	yaoi
䗪	yaoj
遮	yaop
谮	yaqj
讴	yaqy
诬	yaww
谎	yayk
郭	ybbh
诹	ybcy
享	ybf
邝	ybh
邡	obh
亨	ybj
离	ybmc
诎	ybmh
烹	ybou
鹑	ybqg
敦	ybty
亸	ybuj
塾	ybvf
熟	ybvo
孰	ybvy
弃	ycaj
袤	ycne
序	ycnh
谲	ycnk
育	ycef
诵	yceh
裛	yceu
译	ycfh
诒	yckg
充	ycqb
诂	ydg
𫍯	ydgy
庆	ydi
诔	ydiy
诽	yjdd
齑	yjdj
庵	ydjn
斋	ydmj
诚	ydny
诙	ydoy
庞	ydxy
谖	yefc
诅	yegg
裔	yemk
谣	yerm
衣	yeu
哀	yeu
诼	yeyy
庋	yfci
庄	yfd
诖	yffg
庤	yffi
诗	yffy
计	yfh
讦	yfh
讲	yfjh
诘	yfkg
谳	yfmd
读	yfnd
讳	yfnh
庑	yfqv
诸	yfjg
庱	yfwt
讨	yfy
斌	ygah
赟	ygam
𨭉	ygaq
主	ygd
请	ygeg
𬣙	yfhh
证	yghg
𬤝	ygjn
语	ygkg
谏	ygli
廒	ygqt
𬣡	yfxy
评	yguf
谑	yhag
诐	yhcy
让	yhg
店	yhkd
卞	yhu
讣	yhy
应	yid
鹫	yidg
就	yidy
诮	yieg
勍	yilt
谠	yipq
京	yiu
廛	yjff
𬤊	yjgh
刘	yjh
齐	yjj
剂	yjjh
谩	yjlc
谒	yjqn
裹	yjse
课	yjsy
吝	ykf
误	ykgd
衰	ykge
训	ykh
衷	ykhe
谴	ykhp
襄	ykke
谔	ykkn
瓤	ykky
识	ykwy
廙	ylaw
谓	yleg
亩	ylf
𫍽	ylge
库	ylk
亶	ylkg
鹯	ylkg
禀	ylki
颤	ylkm
𠅤	ylnu
谡	ylwt
为	ylyi
亢	ymb
设	ymcy
庙	ymd
颃	ymdm
调	ymfk
𫍣	ymgk
讪	ymh
市	ymhj
鄗	ymkb
敲	ymkc
高	ymkf
诇	ymkg
讥	ymn
讽	ymqy
讷	ymwy
邙	ynbh
扉	ynjd
戾	yndi
户	yne
肩	yned
肓	ynef
望	yneg
讯	ynfh
诩	yng
词	yngk
谞	ynhe
盲	ynhf
扂	ynhk
永	ynii
昶	ynij
鄜	ynjb
麝	ynjf
麈	ynjg
麟	ynjh
麖	ynji
麂	ynjm
麋	ynjo
鏖	ynjq
麑	ynjq
麇	ynjt
麒	ynjw
鹿	ynjx
麀	ynjx
扈	ynkc
启	ynkd
赢	ynky
嬴	ynky
羸	ynky
蠃	ynky
扁	ynma
扃	ynmk
翩	ynmn
遍	ynmp
记	ynn
氓	ynna
扇	ynnd
忘	ynnu
扊	ynoo
扅	ynqq
肇	ynth
綮	ynti
刻	yntj
劾	yntl
谧	yntl
颏	yntm
棨	ynts
亥	yntw
废	ynty
忞	ynu
戽	ynuf
亡	ynv
妄	ynvf
谬	ynwe
廖	ynwe
诀	ynwy
雇	ynwo
扆	ynye
房	ynoe
弈	yoaj
孪	yobf
变	yocu
奕	yodu
蛮	yoju
峦	yomj
脔	yomw
恋	yonu
谈	yooy
迹	yopi
谜	yopy
銮	yoqf
鸾	yoqg
挛	yorj
栾	yosu
亦	you
娈	yovf
弯	yoxb
谊	ypeg
豪	ypeu
𬣞	ypgg
这	ypi
膏	ypke
诨	yplh
亮	ypmb
亭	ypsj
诧	ypta
亳	ypta
毫	yptn
底	yqay
诋	yqay
讻	yqbh
诡	yqdb
谵	yqdy
廨	yqeh
义	yqi
询	yqjg
谗	yqku
庖	yqnv
𫷷	yqqw
诳	yegg
诌	yqvg
谄	yqeg
诤	yqvh
诟	yrgk
䜣	yrh
诛	yriy
廆	yrqc
庳	yrtf
亵	yrve
诉	yryy
𬤇	ysfg
订	ysh
床	ysi
谭	ysjh
诃	yskg
魔	yssc
麽	yssc
磨	yssd
靡	yssd
麻	yssi
縻	yssi
麾	yssn
糜	ysso
摩	yssr
旗	otaw
施	otbn
话	ytdg
旖	otdk
膂	otee
诱	ytet
旅	otey
许	ytfh
诰	yrkg
庭	ytfp
诜	yrqn
旆	otgh
诈	ythf
诞	ythp
旐	otqi
谢	ytmf
旃	otmy
旋	otnh
讫	ytnn
旎	otnx
族	ottd
旌	ottg
𬸦	ottg
旄	ottn
旞	otup
诿	ytvg
诲	ytxu
放	oty
州	ytyh
旒	otyk
详	yudh
庠	yudk
谫	yuev
谰	yugi
斓	yugi
谙	yujg
说	yukq
谪	yumd
谱	yuoj
谛	yuph
谤	yupo
谚	yute
谦	yuvo
廉	yuvo
谥	yuwl
郎	yvcb
朗	yvce
塱	yvcf
㮾	yvcs
𬣳	yvey
鄘	yveb
庸	yveh
良	yvei
裒	yeeu
鄌	yvhb
廋	yehc
𫍲	yehc
唐	yvhk
康	yvii
诏	yvkg
鹒	yvwg
庚	yvwi
庾	yewi
赓	yvwm
谀	yewy
讱	yvyy
讼	ywcy
诊	ywet
亹	ywfg
府	ywfi
腐	ywfw
诠	ywgg
谕	ywgj
褒	ywke
庥	ywsi
夜	ywty
於	owuy
膺	ywwe
卒	ywwf
座	ywwf
鹰	ywwg
谶	ywwg
讹	ywxn
论	ywxn
认	ywy
谁	ywog
谂	ywyn
谯	ywoo
庼	yxdm
率	yxif
紊	yxiu
诣	yxjg
畜	yxlf
饔	yxte
壅	yxtf
雍	yxto
玄	yxu
谐	yxxr
庇	yxxv
廓	yybb
谆	yybg
堃	ooff
方	oygt
广	yygt
文	yygy
谅	yyiy
廪	yyli
访	yot
谝	yyna
庐	yyne
该	yynw
议	yyqy
廊	yyvb
谇	yywf
言	yyyy
菚	aaar
匞	aad
甙	aafd
茇	adcu
碁	adwd
鞹	akyb
艹	aghh
匚	agn
廾	agth
跫	amyh
炁	aqou
菈	aruf
薙	atdo
菸	aowu
阢	bgqn
芔	bhbh
屮	bhk
刵	bjh
凵	bnh
卩	bnh
阝	bnh
厶	cny
磺	damw
礤	dawi
髟	ket
冇	dmb
矽	dqy
歷	dtth
硷	dwgi
砩	dxjh
肜	eet
朊	efqn
膣	epwf
爲	etno
彡	ettt
膪	eupk
臁	eyuo
垅	fdxn
犎	fffh
剺	fitv
丼	fjyi
囍	fkuk
堀	fnbm
謦	fnmy
坶	fxgu
圡	fyi
玨	ggg
珡	ggwu
丌	gjk
珮	gmgh
巿	gmhk
虍	hav
攴	hcu
眛	hfiy
眜	hgsy
丨	hhll
砦	hxdf
瞓	hykh
濛	iape
濊	ihdt
沢	inyy
泶	ipiu
渖	ipjh
沲	itbn
氵	iyyt
蠛	jaly
螓	jdwt
時	jffy
刂	jhh
蟓	jqje
蚵	jskg
蚡	jwvn
咁	kafg
哋	kfbn
啩	kffh
咭	kfkg
吋	kfy
蹓	lqvl
嘢	kjfb
呎	knyy
別	kqjh
啲	krqy
嚟	ktqi
噷	kujw
嘦	kwsv
喺	kwti
唸	kwyn
哜	kyjh
囝	lbd
車	lghh
囗	lhng
軎	lkf
〇	llll
嬲	llvl
囧	lwmv
眾	lthw
豊	magu
觍	mawq
冂	mhn
飚	mqoo
內	mtyi
卐	nghg
卍	nhgh
疋	nli
屌	nkmh
屄	npwi
𪨊	nwwi
忄	nthy
熳	ojlc
灬	otyy
廴	pny
冧	pssu
袴	pudn
衤	pui
裡	pujf
窆	pwtp
祂	pybn
礻	pyi
冖	ptn
辶	pyny
宀	pytn
钸	qdmh
欷	qdmw
鳋	pcyj
鳆	ptjt
鲶	pwyn
镙	qlxi
饣	qnb
馀	qnww
钶	qskg
犭	etnt
钅	qtgn
猓	ejsy
勹	qtn
猸	enhh
镟	qotl
揲	rans
拚	rcah
捱	rdff
扌	rght
擗	rnku
摺	rnnr
紥	rnxi
揎	rpgg
撚	rqdo
挢	rtdj
揞	rujg
搿	rwgr
楱	sdwd
槅	sgkh
醣	sgyk
榀	skkk
麴	swwo
乇	tav
榘	tdas
舡	teag
舨	terc
齄	thlg
箝	traf
牠	rhbn
牜	rhd
攵	ttgy
丿	ttll
夂	ttny
簦	togu
後	txty
肏	tymw
痖	ugog
凃	uwsw
冫	uyg
疒	uygg
丬	uygh
嬅	vagf
娬	vgah
肀	vhk
彐	vngg
巛	vnnn
娒	vtxu
嬢	vuae
佢	wang
伕	wfwy
佧	whhy
氽	wiu
個	wldg
亻	wth
們	wug
卻	wwkb
弪	xcag
彊	xglg
糸	xiu
缋	xkhm
缍	xtgf
給	xiwk
缏	xwgq
纟	xxxx
憝	ybtn
诶	yctd
彣	yee
這	ypd
詝	ypsh
訢	yrh
谘	yuqk
說	ywkq
𤭢	ywwy
庀	yxv
亠	yyg
丶	yyll
讠	yyn
薐	atft
膴	erlo
叒	cccu
奤	ddmd
夿	dcb
砯	dyiy
槻	sfwq
靦	dmjq
堺	flwj
辻	fpk
暻	jjyi
咈	kxjh
鴃	wvgw
曺	gmjf
瑠	gqyl
釭	qag
亜	gkjg
睟	hywf
瞜	hkgv
餗	wyvi
鞞	akrf
畑	olg
尐	iyu
朘	ecwt
啛	kgvv
唻	ksww
咾	kfxn
屩	nttk
柾	sghg
鉥	qsyy
韛	nhke
瘝	ulii
熯	oakw
燔	otol
阬	bymn
睒	hooy
鮟	ppvg
鱇	pyvi
掟	rply
咲	kudy
嶌	mqvo
鱀	vcao
梶	sntn
柸	sdhg
呴	kqkg
垝	fqdb
齆	thlc
玧	gcqn
咶	ktdg
睍	hhqn
檵	sxxn
髈	meuo
畊	lfjh
蠙	jpgm
氹	nii
𰻝	pwyp
閦	uwww
佉	wfcy
気	rnqi
曱	jhk
甴	jhk
塍	euwf
漢	iakw
咢	kkfn
垇	fhng
蘋	ahim
澫	iajy
漍	ilag
曽	uljf
塸	fakk
禇	pyfj
鴜	hxwo
岕	mwjj
埨	fwga
坵	frgg
栜	sgmi
輋	mdlj
塭	fjlg
崠	mgji
沶	ifiy
唦	kiit
荅	awgk
鶄	gewo
鮜	prgk
浿	imy
迴	lkpd
髙	yjfk
礐	eqqd
躴	tmdv
廻	lkpd
逥	mjfp
泘	ituh
嵦	mmgu
巁	mduy
銶	qfiy
竂	pwdi
膫	edui
酄	akkb
糦	ofkk
屢	nkgv
嫰	vgkw
荍	anht
欽	qqwy
棡	smum
遶	fffp
澗	iujg
縳	xigf
甽	lkh
聖	bkgf
龍	uegd
澔	irrk
銀	qvey
攩	ripo
査	segf
饦	qnta
蠵	jmwk
躄	nkul
寯	pwon
蔘	acce
鰕	pnhc
鸊	nkuo
鷉	rhao
鮰	plkg
倖	wfuf
鮸	pqkq
筴	tdww
厽	cccu
㐂	aaab
孨	bbbf
驫	cccu
猋	dddu
䆐	dwtu
壵	ffff
歮	hhhf
瞐	hhhf
尛	iiiu
畾	lllf
惢	nnnu
飝	nutj
鱻	pppu
掱	rrrj
舙	tdtf
羴	uduj
龘	uegd
刕	vvvb
姦	vvvf
麤	ynjx
𡘙	dddu
𤾩	djdj
㠭	aaaa
厵	drii
朤	eeee
嚞	fkfk
靐	klkl
㵘	iiiu
𣊭	jjjj
劦	lllr
㴇	iiiu
飍	mtjj
犇	rhrh
灥	riri
䨺	kfcc
㽓	tgtg
馫	tjtj
䖃	adkk
䲜	pppp
㗊	kkkk
䨻	klkl
雥	wowo
雦	wowo
譶	yyyf
龘 	uegd
迍	gbnp
邅	ylkp
岹	mvkg
䓮	acbt
蔧	adhv
菶	adwh
葧	afpl
䩺	akwn
劻	agln
菓	ajsu
蓷	arwo
菻	assu
䒷	atdf
鹥	atdg
蒠	athn
䕅	avec
駪	crqn
鬅	keee
鬐	kefj
鬇	keqh
髴	kexj
髣	keob
㓦	djjh
郕	dnnb
䀇	drml
磈	drqc
昚	dujf
胵	egcf
腷	egkl
辵	elu
飖	ermq
膍	etlx
脝	eybh
塨	fawi
埈	fcwt
塽	fdqq
雲	kfcu
冓	djmf
霫	knnr
赯	foyk
雰	kwvb
瑊	gdgy
玗	gsh
琹	ggsu
瑇	ggxu
玏	gln
琠	gmaw
瑸	gprw
豗	gqei
琍	gtjh
珓	guqy
睊	hkeg
叡	hpgc
睺	hwnd
啙	hxkk
洏	idmj
㶉	iexg
濬	ihph
虩	ijim
魙	ilrc
淈	inbm
沴	iwet
滽	iyvh
蟖	jadr
曚	jape
蠮	jatn
昰	jghf
晸	jght
蛅	jhkg
毷	jhtn
蟷	jipl
蛼	jlh
鷃	jpvo
螲	jpwf
蝜	jqmy
蝂	jthc
䖮	jtmk
螉	jwcn
蛜	jwvt
蟅	jyao
暠	jymk
旼	jyy
嚱	khaa
跅	lryy
蹻	ltdk
氉	kkkn
喣	kqko
喓	ksvg
嗈	kvkc
喰	kwye
嗻	kyao
㘥	leri
罣	lfff
罥	lkef
軥	lqkg
畇	lqug
䍡	lynx
巏	mako
骳	mehc
骫	mevy
帵	mhpb
崑	mjxx
岧	mvkf
嶕	mwoo
雘	myac
㞎	ncv
㞘	neyi
愊	ngkl
懆	nkks
鴂	nwwo
煐	oamd
炡	oghg
粄	orcy
炤	ovkg
寔	pjgl
鹓	pqbg
礽	pyet
錤	qadw
鋹	qkey
馎	qngf
饾	qngu
饤	qnsh
鱊	pcnk
鯮	ppfi
鮀	ppxn
鮗	ptuu
魮	pxxn
迻	qqpi
匋	qrmk
犼	ebnn
獕	emwo
㺀	eqrn
録	qviy
挼	revg
皝	rgiq
揦	rgkj
搢	rgoj
樋	scep
榎	sdht
槙	sfhw
醄	sgqm
酕	sgtn
枑	sgng
桜	sivg
杋	smyy
栘	sqqy
蜤	srju
棅	stgy
樀	sumd
楢	susg
梐	sxxf
篨	tbww
矱	tdac
舺	telh
玍	tff
籧	thap
笘	thkf
䄻	tqiy
䇽	trrh
稖	tukg
稊	tuxt
箯	twgq
䵚	twie
慜	txgn
瘄	uajd
㿔	ulll
蟞	umij
嫳	umiv
閟	unte
螀	uqju
㾦	uukd
姁	vqkg
伷	wmg
侐	wtlg
儁	wwon
綝	xssy
觺	xtde
緌	xtvg
纀	xwoy
廞	yqqw
褎	ywfe
𮐨	ammv
𮔅	jqmy
𮖁	pugw
𫰂	dfjh
𫐘	ldgn
𫌨	qimq
𣭲	cetn
𣘗	saak
𫄫	xynd
𮭨	jpvg
𨱍	qyvb
𬬺	qegg
𪠳	klg
𨃅	lrdh
𫗦	qngy
𬖑	omqn
𫍟	ytbn
𮩛	qnxf
𫗠	qnta
𬧀	luqf
𫐖	lnwe
𡒄	fyli
𢙐	npey
𧏾	aadj
𤝽	evfh
𦌊	lgkw
𣐿	syey
𠉂	wdpy
𪞝	ucfh
𪨇	gqkm
𫂈	tyny
𫗩	qnlq
𫗮	qnrg
𫚔	plkg
𫛶	gkig
𬸅	qvqg
𮝺	lajn
𮫂	keps
瑯	gyvb
痺	urtf
暱	jaak
妳	vqiy
徬	tupo
煖	oefc
榊	spyh
簷	tqdy
狛	erg
箣	tgmj
瑮	gssy
蟱	jrlo
瓟	rcyn
劵	udlb
寛	pahq
徳	tfln
囮	lwxv
勗	jegl
畠	rlf
円	mhgd
脇	elll
歩	hitr
姵	vmgh
唃	kqeh
関	uudi
広	yci
沬	ifiy
孮	bpfi
苳	atuu
穉	tnih
嘅	kvcq
壆	eqqf
戸	gnr
荵	avyn
鵙	mwvo
狓	ehcy
姫	vahh
蒾	aopu
訸	yty
橿	sglg
憍	ntdk
韮	ajdg
冚	pmj
栃	srdn
鞚	akpa
滈	iymk
嶋	mwvo
懃	akgn
痲	ussq
瑴	fpgc
沕	iqrt
卨	hmnk
燿	onno
雫	kghu
囓	kdhb
椝	fwms
毘	lxxb
禨	pyxt
巻	udnb
椛	sawx
萮	awgj
弐	gafd
絵	xwfc
娭	vctd
毑	xgub
褧	boye
楤	sqrn
笹	tanb
萐	agvl
殽	qdec
莕	askf
脷	etjh
旛	ottl
脰	egku
冴	uaht
鏸	qgjn
稲	tehj
椇	shwy
鑨	qued
鱥	phgy
嫇	vpju
藋	anwo
帢	mhwk
奨	uefd
偪	wgkl
蓚	awhe
痡	ugey
蟌	jtln
撦	rdfj
粃	oxxn
鷇	fpgc
扥	rtan
鱵	ptdy
猲	ejqw
搥	rwnp
奯	dhdy
笩	twau
駄	cdyy
鵖	vcwo
榣	sqrm
蔵	adat
祴	pyaa
鯥	pfwf
実	pdwu
醿	sgyi
陁	btbn
欱	wgkw
餤	wyvo
餬	wyve
挐	vkrj
棯	swyn
慴	nnrg
覇	sake
瞚	hpgw
吷	knwy
抂	rgg
泆	irwy
寖	pivc
帯	gkgh
潃	itte
跼	lnnk
鮨	pxjg
埳	fqeg
恇	nagg
鬭	hggr
稇	tlsy
瀬	igkm
裀	puld
咗	kdag
拏	vcrj
攞	rlxo
欿	qeqw
渿	isfi
禆	pyrf
唲	keqn
倗	weeg
蟚	fkuj
窾	pwfw
斨	nhdr
蚑	jfcy
餽	wyvc
撽	rrot
惸	nqjb
阨	bdbn
箎	tham
蘡	ammv
呬	klg
臡	akfw
眴	hqjg
鼪	enug
麿	yssk
臞	ehho
牸	rhpb
虵	jbn
菫	agkg
蘗	anks
弾	xijf
逷	jqrp
穂	tgmn
剸	gjhj
褦	pucx
讬	ytan
粧	oyfg
浄	iqvh
潝	iwgn
訿	yhxn
歔	haow
柅	snxn
祫	pywk
醎	sgdy
捰	rjsy
篰	tukb
厓	dffd
燐	ooqh
栔	dhvs
恵	gmnu
賸	eudm
碫	dwdc
褱	ylie
蜋	jyve
遝	lipi
汚	ifnn
徯	texd
増	fulj
麞	yxjj
汦	iqan
蹱	lujf
煑	fjou
劚	nilj
斲	nngr
檇	swom
漙	igjf
惣	rhqn
伝	wfcy
児	hjqb
変	yotu
峇	mwgk
栢	sdjg
糢	oajd
冨	pgkl
歛	wgkw
覩	fjhq
宍	puu
蛯	jfxn
巎	mght
苅	aqjj
寊	phmu
葇	acbs
嵙	mtuf
簁	tthl
駆	caqy
聡	bwcn
呾	kjgg
芐	aghu
酖	sgpq
郞	yveb
盌	qblf
鵺	ywto
詧	wyf
鼈	umix
斵	qyvr
寳	pgqm
凪	mhd
儵	whto
搧	rynn
鄎	thnb
禵	pyjm
畺	glgg
鯈	whtp
阰	bxxn
觮	qevi
倶	whgw
檨	sugw
晬	jywf
薠	aodm
夨	gnyi
铓	qayn
撢	rsjf
寈	pgef
塩	ftkl
瑹	gaww
杇	sfnn
戞	depa
郷	xtvb
吚	kvtt
湦	ijtg
榼	sfcl
珔	gdhb
犂	tqth
揑	reag
圀	lwyo
仮	wdcy
蟧	jool
犽	eaht
凊	ugeg
氷	yii
頼	gkim
憗	swwn
褭	yceu
栱	sawy
靫	akcy
菑	avlf
頞	pvdm
慇	rvnn
鶵	qbto
袿	puff
蟼	aqkj
艻	alr
籾	ovyy
紏	xufh
蜑	thpj
勲	tgjo
罉	rmir
斎	yfij
苨	anxb
磵	dujg
惄	hicn
毬	tfny
墺	ftmd
诪	ydtf
珶	guxt
扙	rdyy
椙	sjjg
咷	kqiy
籑	thde
樛	snwe
褵	puyc
疎	nhgi
枌	swvt
鼇	gqtx
虀	ayvg
睩	hviy
鱎	ptdk
黐	twic
斉	yjf
棭	sywy
尅	dqfi
檿	djes
薫	atgo
俛	wqkq
櫜	gkhs
耾	bdcy
菎	ajxx
炰	qnou
嵜	mukh
暒	jjtg
愬	ubtn
竴	uusf
胔	hxmw
抷	rdhg
睔	hwga
薗	alfe
絖	xiqn
啅	khjh
穱	telf
虌	aimx
掻	rcjy
臇	ewom
麕	ynjt
濶	iutd
铦	qtdg
痀	uqkd
拡	rycy
甿	lynn
畷	lccc
寘	pfhw
澞	ihad
飡	uwye
襛	pume
巵	rgcv
鄏	dfeb
薋	auqm
葹	aotb
摵	rdhy
篲	tdhv
秪	tqay
歠	cccw
礉	drot
毎	txfj
灟	inij
僝	wnbb
僽	wton
鬋	keuj
蔕	aaqh
嗙	kupo
搰	rmeg
嫮	vkfn
恑	nqdb
惓	nudb
阯	bhg
秔	tymn
滝	iujn
匄	qynv
鼃	ffxf
愒	njqw
踆	lcwt
婑	vtvg
媠	vdae
呫	khkg
駮	cuqy
踕	lgvl
曀	jfpu
搨	rjng
坱	fmdy
遯	eepi
驩	cako
戦	ijfa
韡	nhkf
枻	sann
佹	wqdb
挵	rgah
鵎	evwo
鵼	pwao
旡	aqv
狶	eqdh
斄	fitw
睠	hudb
跧	lwgg
蓱	aiua
嚤	kysr
眐	hghg
儗	wxtl
袵	puwf
獚	eamw
嬝	vwve
顑	dgkm
澨	itaw
枡	stah
楺	scbs
彍	xyaw
虘	haeg
鴫	lwvo
痌	umgk
癏	ulge
悮	nkgd
揜	rwga
怱	qryn
崕	mdff
斁	lfut
媮	vwgj
媟	vans
雝	vkco
覊	sakc
涽	iqaj
燄	qeoo
哫	kly
眅	hrcy
勷	ykkl
惏	nssy
蠄	jwyc
狟	egjg
憰	ncbk
呿	kfcy
囯	lgd
擸	rvln
𢶍	rgdg
硃	driy
慄	nssy
悙	nybn
頫	qidw
羣	vtud
葯	axiy
銈	qffg
纕	xiye
鞿	alxy
媗	vpgg
螌	temj
鱬	pkdj
鵟	egqo
膽	eqdy
霑	kihk
鱂	pnhf
蠪	uegj
鮧	pgxw
鮠	pqdn
龑	uehd
鱣	pykg
鮡	pqiy
噁	kghn
魾	pdhg
蚃	xtju
腄	etgf
矇	hape
磳	dulj
譩	yujn
譆	yfkk
朌	ewvt
苢	ahnn
蹠	lyao
峬	mgey
怳	nkqn
憱	nyin
熚	qjaf
豭	ehnc
𰻞	pwep
A	aaaa
B	bbbb
C	cccc
D	dddd
E	eeee
F	ffff
G	gggg
H	hhhh
I	iiii
J	jjjj
K	kkkk
L	llll
M	mmmm
N	nnnn
O	oooo
P	pppp
Q	qqqq
R	rrrr
S	ssss
T	tttt
U	uuuu
V	vvvv
W	wwww
X	xxxx
Y	yyyy
Z	zzzz
a	aaaa
b	bbbb
c	cccc
d	dddd
e	eeee
f	ffff
g	gggg
h	hhhh
i	iiii
j	jjjj
k	kkkk
l	llll
m	mmmm
n	nnnn
o	oooo
p	pppp
q	qqqq
r	rrrr
s	ssss
t	tttt
u	uuuu
v	vvvv
w	wwww
x	xxxx
y	yyyy
z	zzzz
